States/UTs,Crime Head,Year,Persons arrested during the year_Male,Persons arrested during the year_Female,Persons arrested during the year_Total,Total number of persons under Trial_Male,Total number of persons under Trial_Female,Total number of persons under Trial_Total,Persons whose cases trials were completed during the year_Male,Persons whose cases trials were completed during the year_Female,Persons whose cases trials were completed during the year_Total,Persons convicted_Male,Persons convicted_Female,Persons convicted_Total,Persons acquitted_Male,Persons acquitted_Female,Persons acquitted_Total
Andhra Pradesh,1 - Murder (Section 302 and 303 IPC),2014,68,5,73,171,2,173,32,1,33,3,0,3,29,1,30
Arunachal Pradesh,1 - Murder (Section 302 and 303 IPC),2014,3,0,3,3,0,3,0,0,0,0,0,0,0,0,0
Assam,1 - Murder (Section 302 and 303 IPC),2014,25,0,25,21,0,21,6,0,6,1,0,1,5,0,5
Bihar,1 - Murder (Section 302 and 303 IPC),2014,100,0,100,870,0,870,78,0,78,18,0,18,60,0,60
Chhattisgarh,1 - Murder (Section 302 and 303 IPC),2014,73,5,78,197,5,202,31,0,31,15,0,15,16,0,16
Goa,1 - Murder (Section 302 and 303 IPC),2014,5,0,5,21,3,24,5,0,5,5,0,5,0,0,0
Gujarat,1 - Murder (Section 302 and 303 IPC),2014,50,18,68,311,22,333,11,0,11,3,0,3,8,0,8
Haryana,1 - Murder (Section 302 and 303 IPC),2014,68,3,71,199,3,202,77,0,77,15,0,15,62,0,62
Himachal Pradesh,1 - Murder (Section 302 and 303 IPC),2014,9,1,10,26,1,27,3,0,3,1,0,1,2,0,2
Jammu & Kashmir,1 - Murder (Section 302 and 303 IPC),2014,3,0,3,25,1,26,1,0,1,1,0,1,0,0,0
Jharkhand,1 - Murder (Section 302 and 303 IPC),2014,5,0,5,13,0,13,0,0,0,0,0,0,0,0,0
Karnataka,1 - Murder (Section 302 and 303 IPC),2014,92,10,102,238,12,250,26,1,27,3,0,3,21,1,22
Kerala,1 - Murder (Section 302 and 303 IPC),2014,32,15,47,233,22,255,19,4,23,4,0,4,15,3,18
Madhya Pradesh,1 - Murder (Section 302 and 303 IPC),2014,162,11,173,864,17,881,200,4,204,99,0,99,101,4,105
Maharashtra,1 - Murder (Section 302 and 303 IPC),2014,233,30,263,1842,83,1925,81,4,85,9,0,9,72,4,76
Manipur,1 - Murder (Section 302 and 303 IPC),2014,3,0,3,0,0,0,0,0,0,0,0,0,0,0,0
Meghalaya,1 - Murder (Section 302 and 303 IPC),2014,0,0,0,5,0,5,0,0,0,0,0,0,0,0,0
Mizoram,1 - Murder (Section 302 and 303 IPC),2014,0,0,0,2,0,2,0,0,0,0,0,0,0,0,0
Nagaland,1 - Murder (Section 302 and 303 IPC),2014,0,1,1,0,1,1,0,0,0,0,0,0,0,0,0
Odisha,1 - Murder (Section 302 and 303 IPC),2014,24,2,26,141,5,146,6,0,6,0,0,0,6,0,6
Punjab,1 - Murder (Section 302 and 303 IPC),2014,57,4,61,88,4,92,29,0,29,19,0,19,10,0,10
Rajasthan,1 - Murder (Section 302 and 303 IPC),2014,75,5,80,356,12,368,57,3,60,30,1,31,27,2,29
Sikkim,1 - Murder (Section 302 and 303 IPC),2014,1,0,1,1,0,1,0,0,0,0,0,0,0,0,0
Tamil Nadu,1 - Murder (Section 302 and 303 IPC),2014,117,12,129,389,13,402,44,1,45,12,0,12,32,1,33
Telangana,1 - Murder (Section 302 and 303 IPC),2014,112,7,119,166,6,172,34,0,34,2,0,2,32,0,32
Tripura,1 - Murder (Section 302 and 303 IPC),2014,15,3,18,70,4,74,17,0,17,7,0,7,10,0,10
Uttar Pradesh,1 - Murder (Section 302 and 303 IPC),2014,1087,17,1104,3769,48,3817,570,11,581,335,7,342,233,4,237
Uttarakhand,1 - Murder (Section 302 and 303 IPC),2014,12,0,12,26,0,26,4,0,4,3,0,3,1,0,1
West Bengal,1 - Murder (Section 302 and 303 IPC),2014,125,3,128,166,0,166,14,0,14,3,0,3,11,0,11
A & N Islands,1 - Murder (Section 302 and 303 IPC),2014,0,1,1,14,1,15,3,0,3,2,0,2,1,0,1
Chandigarh,1 - Murder (Section 302 and 303 IPC),2014,2,1,3,9,1,10,7,1,8,7,1,8,0,0,0
D&N Haveli,1 - Murder (Section 302 and 303 IPC),2014,1,0,1,0,0,0,0,0,0,0,0,0,0,0,0
Daman & Diu,1 - Murder (Section 302 and 303 IPC),2014,0,0,0,0,0,0,0,0,0,0,0,0,0,0,0
Delhi UT,1 - Murder (Section 302 and 303 IPC),2014,46,0,46,362,2,364,25,0,25,18,0,18,7,0,7
Lakshadweep,1 - Murder (Section 302 and 303 IPC),2014,0,0,0,0,0,0,0,0,0,0,0,0,0,0,0
Puducherry,1 - Murder (Section 302 and 303 IPC),2014,0,0,0,0,0,0,0,0,0,0,0,0,0,0,0
Total (States),1 - Murder (Section 302 and 303 IPC),2014,2556,152,2708,10213,264,10477,1345,29,1374,588,8,596,753,20,773
Total (UTs),1 - Murder (Section 302 and 303 IPC),2014,49,2,51,385,4,389,35,1,36,27,1,28,8,0,8
Total (All India),1 - Murder (Section 302 and 303 IPC),2014,2605,154,2759,10598,268,10866,1380,30,1410,615,9,624,761,20,781
Andhra Pradesh,10 - Procuration of minor girls (Section 366-A IPC),2014,34,0,34,37,0,37,19,0,19,0,0,0,19,0,19
Arunachal Pradesh,10 - Procuration of minor girls (Section 366-A IPC),2014,2,0,2,4,0,4,0,0,0,0,0,0,0,0,0
Assam,10 - Procuration of minor girls (Section 366-A IPC),2014,303,0,303,75,0,75,11,0,11,5,0,5,6,0,6
Bihar,10 - Procuration of minor girls (Section 366-A IPC),2014,238,0,238,601,0,601,18,0,18,8,0,8,10,0,10
Chhattisgarh,10 - Procuration of minor girls (Section 366-A IPC),2014,1,2,3,1,2,3,0,0,0,0,0,0,0,0,0
Goa,10 - Procuration of minor girls (Section 366-A IPC),2014,0,0,0,11,3,14,0,0,0,0,0,0,0,0,0
Gujarat,10 - Procuration of minor girls (Section 366-A IPC),2014,0,0,0,1,0,1,0,0,0,0,0,0,0,0,0
Haryana,10 - Procuration of minor girls (Section 366-A IPC),2014,272,0,272,255,0,255,62,0,62,5,0,5,57,0,57
Himachal Pradesh,10 - Procuration of minor girls (Section 366-A IPC),2014,2,0,2,6,1,7,0,0,0,0,0,0,0,0,0
Jammu & Kashmir,10 - Procuration of minor girls (Section 366-A IPC),2014,0,0,0,1,0,1,1,0,1,0,0,0,1,0,1
Jharkhand,10 - Procuration of minor girls (Section 366-A IPC),2014,17,0,17,18,0,18,4,0,4,2,0,2,2,0,2
Karnataka,10 - Procuration of minor girls (Section 366-A IPC),2014,55,1,56,109,2,111,15,0,15,1,0,1,14,0,14
Kerala,10 - Procuration of minor girls (Section 366-A IPC),2014,4,0,4,124,0,124,7,0,7,0,0,0,7,0,7
Madhya Pradesh,10 - Procuration of minor girls (Section 366-A IPC),2014,13,0,13,43,0,43,5,0,5,2,0,2,3,0,3
Maharashtra,10 - Procuration of minor girls (Section 366-A IPC),2014,7,0,7,300,13,313,1,0,1,0,0,0,1,0,1
Manipur,10 - Procuration of minor girls (Section 366-A IPC),2014,0,0,0,0,0,0,0,0,0,0,0,0,0,0,0
Meghalaya,10 - Procuration of minor girls (Section 366-A IPC),2014,12,0,12,10,0,10,0,0,0,0,0,0,0,0,0
Mizoram,10 - Procuration of minor girls (Section 366-A IPC),2014,0,0,0,0,0,0,0,0,0,0,0,0,0,0,0
Nagaland,10 - Procuration of minor girls (Section 366-A IPC),2014,0,0,0,0,0,0,0,0,0,0,0,0,0,0,0
Odisha,10 - Procuration of minor girls (Section 366-A IPC),2014,30,2,32,111,2,113,24,0,24,0,0,0,24,0,24
Punjab,10 - Procuration of minor girls (Section 366-A IPC),2014,3,1,4,5,2,7,2,1,3,1,0,1,1,1,2
Rajasthan,10 - Procuration of minor girls (Section 366-A IPC),2014,36,0,36,112,0,112,10,0,10,4,0,4,3,0,3
Sikkim,10 - Procuration of minor girls (Section 366-A IPC),2014,0,0,0,0,0,0,0,0,0,0,0,0,0,0,0
Tamil Nadu,10 - Procuration of minor girls (Section 366-A IPC),2014,0,0,0,20,0,20,10,0,10,0,0,0,10,0,10
Telangana,10 - Procuration of minor girls (Section 366-A IPC),2014,33,0,33,81,0,81,28,0,28,0,0,0,23,0,23
Tripura,10 - Procuration of minor girls (Section 366-A IPC),2014,0,0,0,0,0,0,0,0,0,0,0,0,0,0,0
Uttar Pradesh,10 - Procuration of minor girls (Section 366-A IPC),2014,0,0,0,2,0,2,2,0,2,2,0,2,0,0,0
Uttarakhand,10 - Procuration of minor girls (Section 366-A IPC),2014,0,0,0,5,0,5,1,0,1,1,0,1,0,0,0
West Bengal,10 - Procuration of minor girls (Section 366-A IPC),2014,886,13,899,1373,27,1400,75,2,77,2,0,2,73,2,75
A & N Islands,10 - Procuration of minor girls (Section 366-A IPC),2014,0,0,0,0,0,0,0,0,0,0,0,0,0,0,0
Chandigarh,10 - Procuration of minor girls (Section 366-A IPC),2014,0,0,0,0,0,0,0,0,0,0,0,0,0,0,0
D&N Haveli,10 - Procuration of minor girls (Section 366-A IPC),2014,0,0,0,0,0,0,0,0,0,0,0,0,0,0,0
Daman & Diu,10 - Procuration of minor girls (Section 366-A IPC),2014,0,0,0,0,0,0,0,0,0,0,0,0,0,0,0
Delhi UT,10 - Procuration of minor girls (Section 366-A IPC),2014,0,0,0,1,0,1,0,0,0,0,0,0,0,0,0
Lakshadweep,10 - Procuration of minor girls (Section 366-A IPC),2014,0,0,0,0,0,0,0,0,0,0,0,0,0,0,0
Puducherry,10 - Procuration of minor girls (Section 366-A IPC),2014,0,0,0,0,0,0,0,0,0,0,0,0,0,0,0
Total (States),10 - Procuration of minor girls (Section 366-A IPC),2014,1948,19,1967,3305,52,3357,295,3,298,33,0,33,254,3,257
Total (UTs),10 - Procuration of minor girls (Section 366-A IPC),2014,0,0,0,1,0,1,0,0,0,0,0,0,0,0,0
Total (All India),10 - Procuration of minor girls (Section 366-A IPC),2014,1948,19,1967,3306,52,3358,295,3,298,33,0,33,254,3,257
Andhra Pradesh,11 - Importation of Girls from Foreign Country (Section 366-B IPC),2014,0,0,0,0,0,0,0,0,0,0,0,0,0,0,0
Arunachal Pradesh,11 - Importation of Girls from Foreign Country (Section 366-B IPC),2014,0,0,0,0,0,0,0,0,0,0,0,0,0,0,0
Assam,11 - Importation of Girls from Foreign Country (Section 366-B IPC),2014,0,0,0,0,0,0,0,0,0,0,0,0,0,0,0
Bihar,11 - Importation of Girls from Foreign Country (Section 366-B IPC),2014,0,0,0,0,0,0,0,0,0,0,0,0,0,0,0
Chhattisgarh,11 - Importation of Girls from Foreign Country (Section 366-B IPC),2014,0,0,0,0,0,0,0,0,0,0,0,0,0,0,0
Goa,11 - Importation of Girls from Foreign Country (Section 366-B IPC),2014,0,0,0,0,0,0,0,0,0,0,0,0,0,0,0
Gujarat,11 - Importation of Girls from Foreign Country (Section 366-B IPC),2014,0,0,0,0,0,0,0,0,0,0,0,0,0,0,0
Haryana,11 - Importation of Girls from Foreign Country (Section 366-B IPC),2014,0,0,0,0,0,0,0,0,0,0,0,0,0,0,0
Himachal Pradesh,11 - Importation of Girls from Foreign Country (Section 366-B IPC),2014,0,0,0,0,0,0,0,0,0,0,0,0,0,0,0
Jammu & Kashmir,11 - Importation of Girls from Foreign Country (Section 366-B IPC),2014,0,0,0,0,0,0,0,0,0,0,0,0,0,0,0
Jharkhand,11 - Importation of Girls from Foreign Country (Section 366-B IPC),2014,0,0,0,0,0,0,0,0,0,0,0,0,0,0,0
Karnataka,11 - Importation of Girls from Foreign Country (Section 366-B IPC),2014,0,0,0,0,0,0,0,0,0,0,0,0,0,0,0
Kerala,11 - Importation of Girls from Foreign Country (Section 366-B IPC),2014,0,0,0,0,0,0,0,0,0,0,0,0,0,0,0
Madhya Pradesh,11 - Importation of Girls from Foreign Country (Section 366-B IPC),2014,0,0,0,0,0,0,0,0,0,0,0,0,0,0,0
Maharashtra,11 - Importation of Girls from Foreign Country (Section 366-B IPC),2014,0,0,0,0,0,0,0,0,0,0,0,0,0,0,0
Manipur,11 - Importation of Girls from Foreign Country (Section 366-B IPC),2014,0,0,0,0,0,0,0,0,0,0,0,0,0,0,0
Meghalaya,11 - Importation of Girls from Foreign Country (Section 366-B IPC),2014,0,0,0,0,0,0,0,0,0,0,0,0,0,0,0
Mizoram,11 - Importation of Girls from Foreign Country (Section 366-B IPC),2014,0,0,0,0,0,0,0,0,0,0,0,0,0,0,0
Nagaland,11 - Importation of Girls from Foreign Country (Section 366-B IPC),2014,0,0,0,0,0,0,0,0,0,0,0,0,0,0,0
Odisha,11 - Importation of Girls from Foreign Country (Section 366-B IPC),2014,0,0,0,0,0,0,0,0,0,0,0,0,0,0,0
Punjab,11 - Importation of Girls from Foreign Country (Section 366-B IPC),2014,0,0,0,0,0,0,0,0,0,0,0,0,0,0,0
Rajasthan,11 - Importation of Girls from Foreign Country (Section 366-B IPC),2014,0,0,0,0,0,0,0,0,0,0,0,0,0,0,0
Sikkim,11 - Importation of Girls from Foreign Country (Section 366-B IPC),2014,0,0,0,0,0,0,0,0,0,0,0,0,0,0,0
Tamil Nadu,11 - Importation of Girls from Foreign Country (Section 366-B IPC),2014,0,0,0,0,0,0,0,0,0,0,0,0,0,0,0
Telangana,11 - Importation of Girls from Foreign Country (Section 366-B IPC),2014,0,0,0,0,0,0,0,0,0,0,0,0,0,0,0
Tripura,11 - Importation of Girls from Foreign Country (Section 366-B IPC),2014,0,0,0,0,0,0,0,0,0,0,0,0,0,0,0
Uttar Pradesh,11 - Importation of Girls from Foreign Country (Section 366-B IPC),2014,0,0,0,0,0,0,0,0,0,0,0,0,0,0,0
Uttarakhand,11 - Importation of Girls from Foreign Country (Section 366-B IPC),2014,0,0,0,0,0,0,0,0,0,0,0,0,0,0,0
West Bengal,11 - Importation of Girls from Foreign Country (Section 366-B IPC),2014,4,2,6,3,1,4,0,0,0,0,0,0,0,0,0
A & N Islands,11 - Importation of Girls from Foreign Country (Section 366-B IPC),2014,0,0,0,0,0,0,0,0,0,0,0,0,0,0,0
Chandigarh,11 - Importation of Girls from Foreign Country (Section 366-B IPC),2014,0,0,0,0,0,0,0,0,0,0,0,0,0,0,0
D&N Haveli,11 - Importation of Girls from Foreign Country (Section 366-B IPC),2014,0,0,0,0,0,0,0,0,0,0,0,0,0,0,0
Daman & Diu,11 - Importation of Girls from Foreign Country (Section 366-B IPC),2014,0,0,0,0,0,0,0,0,0,0,0,0,0,0,0
Delhi UT,11 - Importation of Girls from Foreign Country (Section 366-B IPC),2014,0,0,0,0,0,0,0,0,0,0,0,0,0,0,0
Lakshadweep,11 - Importation of Girls from Foreign Country (Section 366-B IPC),2014,0,0,0,0,0,0,0,0,0,0,0,0,0,0,0
Puducherry,11 - Importation of Girls from Foreign Country (Section 366-B IPC),2014,0,0,0,0,0,0,0,0,0,0,0,0,0,0,0
Total (States),11 - Importation of Girls from Foreign Country (Section 366-B IPC),2014,4,2,6,3,1,4,0,0,0,0,0,0,0,0,0
Total (UTs),11 - Importation of Girls from Foreign Country (Section 366-B IPC),2014,0,0,0,0,0,0,0,0,0,0,0,0,0,0,0
Total (All India),11 - Importation of Girls from Foreign Country (Section 366-B IPC),2014,4,2,6,3,1,4,0,0,0,0,0,0,0,0,0
Andhra Pradesh,12 - Buying of minors for prostitution (Section 373 IPC),2014,0,0,0,0,0,0,0,0,0,0,0,0,0,0,0
Arunachal Pradesh,12 - Buying of minors for prostitution (Section 373 IPC),2014,0,0,0,0,0,0,0,0,0,0,0,0,0,0,0
Assam,12 - Buying of minors for prostitution (Section 373 IPC),2014,0,0,0,0,0,0,0,0,0,0,0,0,0,0,0
Bihar,12 - Buying of minors for prostitution (Section 373 IPC),2014,0,0,0,3,0,3,1,0,1,0,0,0,0,0,0
Chhattisgarh,12 - Buying of minors for prostitution (Section 373 IPC),2014,0,0,0,0,0,0,0,0,0,0,0,0,0,0,0
Goa,12 - Buying of minors for prostitution (Section 373 IPC),2014,0,0,0,0,0,0,0,0,0,0,0,0,0,0,0
Gujarat,12 - Buying of minors for prostitution (Section 373 IPC),2014,0,0,0,0,0,0,0,0,0,0,0,0,0,0,0
Haryana,12 - Buying of minors for prostitution (Section 373 IPC),2014,1,1,2,4,1,5,0,0,0,0,0,0,0,0,0
Himachal Pradesh,12 - Buying of minors for prostitution (Section 373 IPC),2014,0,0,0,0,0,0,0,0,0,0,0,0,0,0,0
Jammu & Kashmir,12 - Buying of minors for prostitution (Section 373 IPC),2014,0,0,0,0,0,0,0,0,0,0,0,0,0,0,0
Jharkhand,12 - Buying of minors for prostitution (Section 373 IPC),2014,4,0,4,0,0,0,0,0,0,0,0,0,0,0,0
Karnataka,12 - Buying of minors for prostitution (Section 373 IPC),2014,0,0,0,0,0,0,0,0,0,0,0,0,0,0,0
Kerala,12 - Buying of minors for prostitution (Section 373 IPC),2014,0,0,0,0,0,0,0,0,0,0,0,0,0,0,0
Madhya Pradesh,12 - Buying of minors for prostitution (Section 373 IPC),2014,1,0,1,6,0,6,0,0,0,0,0,0,0,0,0
Maharashtra,12 - Buying of minors for prostitution (Section 373 IPC),2014,9,0,9,233,0,233,0,0,0,0,0,0,0,0,0
Manipur,12 - Buying of minors for prostitution (Section 373 IPC),2014,0,0,0,0,0,0,0,0,0,0,0,0,0,0,0
Meghalaya,12 - Buying of minors for prostitution (Section 373 IPC),2014,0,0,0,0,0,0,0,0,0,0,0,0,0,0,0
Mizoram,12 - Buying of minors for prostitution (Section 373 IPC),2014,0,0,0,0,0,0,0,0,0,0,0,0,0,0,0
Nagaland,12 - Buying of minors for prostitution (Section 373 IPC),2014,0,0,0,0,0,0,0,0,0,0,0,0,0,0,0
Odisha,12 - Buying of minors for prostitution (Section 373 IPC),2014,0,0,0,0,0,0,0,0,0,0,0,0,0,0,0
Punjab,12 - Buying of minors for prostitution (Section 373 IPC),2014,0,0,0,0,0,0,0,0,0,0,0,0,0,0,0
Rajasthan,12 - Buying of minors for prostitution (Section 373 IPC),2014,0,0,0,5,0,5,0,0,0,0,0,0,0,0,0
Sikkim,12 - Buying of minors for prostitution (Section 373 IPC),2014,0,0,0,0,0,0,0,0,0,0,0,0,0,0,0
Tamil Nadu,12 - Buying of minors for prostitution (Section 373 IPC),2014,0,0,0,0,0,0,0,0,0,0,0,0,0,0,0
Telangana,12 - Buying of minors for prostitution (Section 373 IPC),2014,0,0,0,0,0,0,0,0,0,0,0,0,0,0,0
Tripura,12 - Buying of minors for prostitution (Section 373 IPC),2014,0,0,0,0,0,0,0,0,0,0,0,0,0,0,0
Uttar Pradesh,12 - Buying of minors for prostitution (Section 373 IPC),2014,0,0,0,4,0,4,0,0,0,0,0,0,0,0,0
Uttarakhand,12 - Buying of minors for prostitution (Section 373 IPC),2014,0,0,0,0,0,0,0,0,0,0,0,0,0,0,0
West Bengal,12 - Buying of minors for prostitution (Section 373 IPC),2014,15,0,15,26,0,26,0,0,0,0,0,0,0,0,0
A & N Islands,12 - Buying of minors for prostitution (Section 373 IPC),2014,0,0,0,0,0,0,0,0,0,0,0,0,0,0,0
Chandigarh,12 - Buying of minors for prostitution (Section 373 IPC),2014,0,0,0,0,0,0,0,0,0,0,0,0,0,0,0
D&N Haveli,12 - Buying of minors for prostitution (Section 373 IPC),2014,0,0,0,0,0,0,0,0,0,0,0,0,0,0,0
Daman & Diu,12 - Buying of minors for prostitution (Section 373 IPC),2014,0,0,0,0,0,0,0,0,0,0,0,0,0,0,0
Delhi UT,12 - Buying of minors for prostitution (Section 373 IPC),2014,0,0,0,0,0,0,0,0,0,0,0,0,0,0,0
Lakshadweep,12 - Buying of minors for prostitution (Section 373 IPC),2014,0,0,0,0,0,0,0,0,0,0,0,0,0,0,0
Puducherry,12 - Buying of minors for prostitution (Section 373 IPC),2014,0,0,0,0,0,0,0,0,0,0,0,0,0,0,0
Total (States),12 - Buying of minors for prostitution (Section 373 IPC),2014,30,1,31,281,1,282,1,0,1,0,0,0,0,0,0
Total (UTs),12 - Buying of minors for prostitution (Section 373 IPC),2014,0,0,0,0,0,0,0,0,0,0,0,0,0,0,0
Total (All India),12 - Buying of minors for prostitution (Section 373 IPC),2014,30,1,31,281,1,282,1,0,1,0,0,0,0,0,0
Andhra Pradesh,13 - Selling of minors for prostitution (Section 372 IPC),2014,0,0,0,14,0,14,8,0,8,0,0,0,8,0,8
Arunachal Pradesh,13 - Selling of minors for prostitution (Section 372 IPC),2014,0,0,0,0,0,0,0,0,0,0,0,0,0,0,0
Assam,13 - Selling of minors for prostitution (Section 372 IPC),2014,0,0,0,0,0,0,0,0,0,0,0,0,0,0,0
Bihar,13 - Selling of minors for prostitution (Section 372 IPC),2014,0,0,0,20,0,20,0,0,0,0,0,0,0,0,0
Chhattisgarh,13 - Selling of minors for prostitution (Section 372 IPC),2014,2,3,5,2,3,5,0,0,0,0,0,0,0,0,0
Goa,13 - Selling of minors for prostitution (Section 372 IPC),2014,0,0,0,0,0,0,0,0,0,0,0,0,0,0,0
Gujarat,13 - Selling of minors for prostitution (Section 372 IPC),2014,0,0,0,0,0,0,0,0,0,0,0,0,0,0,0
Haryana,13 - Selling of minors for prostitution (Section 372 IPC),2014,0,0,0,0,0,0,0,0,0,0,0,0,0,0,0
Himachal Pradesh,13 - Selling of minors for prostitution (Section 372 IPC),2014,0,0,0,0,0,0,0,0,0,0,0,0,0,0,0
Jammu & Kashmir,13 - Selling of minors for prostitution (Section 372 IPC),2014,0,0,0,0,0,0,0,0,0,0,0,0,0,0,0
Jharkhand,13 - Selling of minors for prostitution (Section 372 IPC),2014,0,0,0,0,0,0,0,0,0,0,0,0,0,0,0
Karnataka,13 - Selling of minors for prostitution (Section 372 IPC),2014,0,0,0,0,0,0,0,0,0,0,0,0,0,0,0
Kerala,13 - Selling of minors for prostitution (Section 372 IPC),2014,0,0,0,0,0,0,0,0,0,0,0,0,0,0,0
Madhya Pradesh,13 - Selling of minors for prostitution (Section 372 IPC),2014,4,0,4,38,0,38,13,0,13,0,0,0,4,0,4
Maharashtra,13 - Selling of minors for prostitution (Section 372 IPC),2014,4,0,4,63,2,65,0,2,2,0,0,0,0,1,1
Manipur,13 - Selling of minors for prostitution (Section 372 IPC),2014,0,0,0,0,0,0,0,0,0,0,0,0,0,0,0
Meghalaya,13 - Selling of minors for prostitution (Section 372 IPC),2014,0,0,0,0,0,0,0,0,0,0,0,0,0,0,0
Mizoram,13 - Selling of minors for prostitution (Section 372 IPC),2014,0,0,0,0,0,0,0,0,0,0,0,0,0,0,0
Nagaland,13 - Selling of minors for prostitution (Section 372 IPC),2014,0,0,0,0,0,0,0,0,0,0,0,0,0,0,0
Odisha,13 - Selling of minors for prostitution (Section 372 IPC),2014,0,0,0,0,0,0,0,0,0,0,0,0,0,0,0
Punjab,13 - Selling of minors for prostitution (Section 372 IPC),2014,0,0,0,0,0,0,0,0,0,0,0,0,0,0,0
Rajasthan,13 - Selling of minors for prostitution (Section 372 IPC),2014,0,0,0,10,0,10,9,0,9,0,0,0,9,0,9
Sikkim,13 - Selling of minors for prostitution (Section 372 IPC),2014,0,0,0,0,0,0,0,0,0,0,0,0,0,0,0
Tamil Nadu,13 - Selling of minors for prostitution (Section 372 IPC),2014,0,0,0,0,0,0,0,0,0,0,0,0,0,0,0
Telangana,13 - Selling of minors for prostitution (Section 372 IPC),2014,0,0,0,7,0,7,0,0,0,0,0,0,0,0,0
Tripura,13 - Selling of minors for prostitution (Section 372 IPC),2014,0,0,0,0,0,0,0,0,0,0,0,0,0,0,0
Uttar Pradesh,13 - Selling of minors for prostitution (Section 372 IPC),2014,0,0,0,35,0,35,1,0,1,1,0,1,0,0,0
Uttarakhand,13 - Selling of minors for prostitution (Section 372 IPC),2014,0,0,0,0,0,0,0,0,0,0,0,0,0,0,0
West Bengal,13 - Selling of minors for prostitution (Section 372 IPC),2014,82,7,89,374,7,381,6,0,6,1,0,1,5,0,5
A & N Islands,13 - Selling of minors for prostitution (Section 372 IPC),2014,0,0,0,0,0,0,0,0,0,0,0,0,0,0,0
Chandigarh,13 - Selling of minors for prostitution (Section 372 IPC),2014,0,0,0,0,0,0,0,0,0,0,0,0,0,0,0
D&N Haveli,13 - Selling of minors for prostitution (Section 372 IPC),2014,0,0,0,0,0,0,0,0,0,0,0,0,0,0,0
Daman & Diu,13 - Selling of minors for prostitution (Section 372 IPC),2014,0,0,0,0,0,0,0,0,0,0,0,0,0,0,0
Delhi UT,13 - Selling of minors for prostitution (Section 372 IPC),2014,2,5,7,5,8,13,1,2,3,1,2,3,0,0,0
Lakshadweep,13 - Selling of minors for prostitution (Section 372 IPC),2014,0,0,0,0,0,0,0,0,0,0,0,0,0,0,0
Puducherry,13 - Selling of minors for prostitution (Section 372 IPC),2014,0,0,0,0,0,0,0,0,0,0,0,0,0,0,0
Total (States),13 - Selling of minors for prostitution (Section 372 IPC),2014,92,10,102,563,12,575,37,2,39,2,0,2,26,1,27
Total (UTs),13 - Selling of minors for prostitution (Section 372 IPC),2014,2,5,7,5,8,13,1,2,3,1,2,3,0,0,0
Total (All India),13 - Selling of minors for prostitution (Section 372 IPC),2014,94,15,109,568,20,588,38,4,42,3,2,5,26,1,27
Andhra Pradesh,"14 - Prohibition of Child Marriage Act, 2006",2014,29,5,34,72,3,75,9,0,9,0,0,0,8,0,8
Arunachal Pradesh,"14 - Prohibition of Child Marriage Act, 2006",2014,0,0,0,0,0,0,0,0,0,0,0,0,0,0,0
Assam,"14 - Prohibition of Child Marriage Act, 2006",2014,4,0,4,2,0,2,0,0,0,0,0,0,0,0,0
Bihar,"14 - Prohibition of Child Marriage Act, 2006",2014,10,0,10,32,0,32,7,0,7,2,0,2,5,0,5
Chhattisgarh,"14 - Prohibition of Child Marriage Act, 2006",2014,4,0,4,4,0,4,0,0,0,0,0,0,0,0,0
Goa,"14 - Prohibition of Child Marriage Act, 2006",2014,0,0,0,4,0,4,0,0,0,0,0,0,0,0,0
Gujarat,"14 - Prohibition of Child Marriage Act, 2006",2014,51,25,76,475,62,537,117,5,122,7,2,9,110,3,113
Haryana,"14 - Prohibition of Child Marriage Act, 2006",2014,15,1,16,40,2,42,14,2,16,5,1,6,9,1,10
Himachal Pradesh,"14 - Prohibition of Child Marriage Act, 2006",2014,11,7,18,41,9,50,10,0,10,0,0,0,10,0,10
Jammu & Kashmir,"14 - Prohibition of Child Marriage Act, 2006",2014,0,0,0,0,0,0,0,0,0,0,0,0,0,0,0
Jharkhand,"14 - Prohibition of Child Marriage Act, 2006",2014,1,0,1,2,0,2,0,0,0,0,0,0,0,0,0
Karnataka,"14 - Prohibition of Child Marriage Act, 2006",2014,58,8,66,144,12,156,36,3,39,3,0,3,32,3,35
Kerala,"14 - Prohibition of Child Marriage Act, 2006",2014,34,7,41,59,8,67,2,0,2,0,0,0,2,0,2
Madhya Pradesh,"14 - Prohibition of Child Marriage Act, 2006",2014,47,11,58,111,19,130,10,2,12,3,1,4,7,1,8
Maharashtra,"14 - Prohibition of Child Marriage Act, 2006",2014,54,18,72,542,120,662,61,7,68,0,0,0,61,7,68
Manipur,"14 - Prohibition of Child Marriage Act, 2006",2014,0,0,0,0,0,0,0,0,0,0,0,0,0,0,0
Meghalaya,"14 - Prohibition of Child Marriage Act, 2006",2014,0,0,0,0,0,0,0,0,0,0,0,0,0,0,0
Mizoram,"14 - Prohibition of Child Marriage Act, 2006",2014,0,0,0,0,0,0,0,0,0,0,0,0,0,0,0
Nagaland,"14 - Prohibition of Child Marriage Act, 2006",2014,0,0,0,0,0,0,0,0,0,0,0,0,0,0,0
Odisha,"14 - Prohibition of Child Marriage Act, 2006",2014,0,0,0,6,0,6,1,0,1,0,0,0,1,0,1
Punjab,"14 - Prohibition of Child Marriage Act, 2006",2014,1,2,3,7,2,9,3,2,5,0,0,0,3,2,5
Rajasthan,"14 - Prohibition of Child Marriage Act, 2006",2014,18,2,20,97,2,99,12,0,12,12,0,12,0,0,0
Sikkim,"14 - Prohibition of Child Marriage Act, 2006",2014,0,0,0,0,0,0,0,0,0,0,0,0,0,0,0
Tamil Nadu,"14 - Prohibition of Child Marriage Act, 2006",2014,93,40,133,147,32,179,26,10,36,5,0,5,21,10,31
Telangana,"14 - Prohibition of Child Marriage Act, 2006",2014,33,9,42,62,7,69,13,2,15,0,0,0,13,2,15
Tripura,"14 - Prohibition of Child Marriage Act, 2006",2014,1,1,2,1,1,2,0,0,0,0,0,0,0,0,0
Uttar Pradesh,"14 - Prohibition of Child Marriage Act, 2006",2014,29,4,33,62,5,67,12,2,14,5,2,7,7,0,7
Uttarakhand,"14 - Prohibition of Child Marriage Act, 2006",2014,0,0,0,0,0,0,0,0,0,0,0,0,0,0,0
West Bengal,"14 - Prohibition of Child Marriage Act, 2006",2014,71,3,74,187,13,200,6,0,6,1,0,1,5,0,5
A & N Islands,"14 - Prohibition of Child Marriage Act, 2006",2014,0,0,0,0,0,0,0,0,0,0,0,0,0,0,0
Chandigarh,"14 - Prohibition of Child Marriage Act, 2006",2014,0,0,0,8,0,8,0,0,0,0,0,0,0,0,0
D&N Haveli,"14 - Prohibition of Child Marriage Act, 2006",2014,0,0,0,0,0,0,0,0,0,0,0,0,0,0,0
Daman & Diu,"14 - Prohibition of Child Marriage Act, 2006",2014,0,0,0,0,0,0,0,0,0,0,0,0,0,0,0
Delhi UT,"14 - Prohibition of Child Marriage Act, 2006",2014,1,0,1,0,0,0,0,0,0,0,0,0,0,0,0
Lakshadweep,"14 - Prohibition of Child Marriage Act, 2006",2014,0,0,0,0,0,0,0,0,0,0,0,0,0,0,0
Puducherry,"14 - Prohibition of Child Marriage Act, 2006",2014,6,4,10,9,6,15,0,0,0,0,0,0,0,0,0
Total (States),"14 - Prohibition of Child Marriage Act, 2006",2014,564,143,707,2097,297,2394,339,35,374,43,6,49,294,29,323
Total (UTs),"14 - Prohibition of Child Marriage Act, 2006",2014,7,4,11,17,6,23,0,0,0,0,0,0,0,0,0
Total (All India),"14 - Prohibition of Child Marriage Act, 2006",2014,571,147,718,2114,303,2417,339,35,374,43,6,49,294,29,323
Andhra Pradesh,"15 - Transplantation of Human Organs Act, 1994",2014,0,0,0,0,0,0,0,0,0,0,0,0,0,0,0
Arunachal Pradesh,"15 - Transplantation of Human Organs Act, 1994",2014,0,0,0,0,0,0,0,0,0,0,0,0,0,0,0
Assam,"15 - Transplantation of Human Organs Act, 1994",2014,0,0,0,0,0,0,0,0,0,0,0,0,0,0,0
Bihar,"15 - Transplantation of Human Organs Act, 1994",2014,0,0,0,0,0,0,0,0,0,0,0,0,0,0,0
Chhattisgarh,"15 - Transplantation of Human Organs Act, 1994",2014,0,0,0,0,0,0,0,0,0,0,0,0,0,0,0
Goa,"15 - Transplantation of Human Organs Act, 1994",2014,0,0,0,0,0,0,0,0,0,0,0,0,0,0,0
Gujarat,"15 - Transplantation of Human Organs Act, 1994",2014,0,0,0,0,0,0,0,0,0,0,0,0,0,0,0
Haryana,"15 - Transplantation of Human Organs Act, 1994",2014,0,0,0,0,0,0,0,0,0,0,0,0,0,0,0
Himachal Pradesh,"15 - Transplantation of Human Organs Act, 1994",2014,0,0,0,0,0,0,0,0,0,0,0,0,0,0,0
Jammu & Kashmir,"15 - Transplantation of Human Organs Act, 1994",2014,0,0,0,0,0,0,0,0,0,0,0,0,0,0,0
Jharkhand,"15 - Transplantation of Human Organs Act, 1994",2014,0,0,0,0,0,0,0,0,0,0,0,0,0,0,0
Karnataka,"15 - Transplantation of Human Organs Act, 1994",2014,0,0,0,0,0,0,0,0,0,0,0,0,0,0,0
Kerala,"15 - Transplantation of Human Organs Act, 1994",2014,0,0,0,0,0,0,0,0,0,0,0,0,0,0,0
Madhya Pradesh,"15 - Transplantation of Human Organs Act, 1994",2014,0,0,0,0,0,0,0,0,0,0,0,0,0,0,0
Maharashtra,"15 - Transplantation of Human Organs Act, 1994",2014,0,0,0,0,0,0,0,0,0,0,0,0,0,0,0
Manipur,"15 - Transplantation of Human Organs Act, 1994",2014,0,0,0,0,0,0,0,0,0,0,0,0,0,0,0
Meghalaya,"15 - Transplantation of Human Organs Act, 1994",2014,0,0,0,0,0,0,0,0,0,0,0,0,0,0,0
Mizoram,"15 - Transplantation of Human Organs Act, 1994",2014,0,0,0,0,0,0,0,0,0,0,0,0,0,0,0
Nagaland,"15 - Transplantation of Human Organs Act, 1994",2014,0,0,0,0,0,0,0,0,0,0,0,0,0,0,0
Odisha,"15 - Transplantation of Human Organs Act, 1994",2014,0,0,0,0,0,0,0,0,0,0,0,0,0,0,0
Punjab,"15 - Transplantation of Human Organs Act, 1994",2014,0,0,0,0,0,0,0,0,0,0,0,0,0,0,0
Rajasthan,"15 - Transplantation of Human Organs Act, 1994",2014,0,0,0,0,0,0,0,0,0,0,0,0,0,0,0
Sikkim,"15 - Transplantation of Human Organs Act, 1994",2014,0,0,0,0,0,0,0,0,0,0,0,0,0,0,0
Tamil Nadu,"15 - Transplantation of Human Organs Act, 1994",2014,0,0,0,0,0,0,0,0,0,0,0,0,0,0,0
Telangana,"15 - Transplantation of Human Organs Act, 1994",2014,0,0,0,0,0,0,0,0,0,0,0,0,0,0,0
Tripura,"15 - Transplantation of Human Organs Act, 1994",2014,0,0,0,0,0,0,0,0,0,0,0,0,0,0,0
Uttar Pradesh,"15 - Transplantation of Human Organs Act, 1994",2014,0,0,0,0,0,0,0,0,0,0,0,0,0,0,0
Uttarakhand,"15 - Transplantation of Human Organs Act, 1994",2014,0,0,0,0,0,0,0,0,0,0,0,0,0,0,0
West Bengal,"15 - Transplantation of Human Organs Act, 1994",2014,0,0,0,0,0,0,0,0,0,0,0,0,0,0,0
A & N Islands,"15 - Transplantation of Human Organs Act, 1994",2014,0,0,0,0,0,0,0,0,0,0,0,0,0,0,0
Chandigarh,"15 - Transplantation of Human Organs Act, 1994",2014,0,0,0,0,0,0,0,0,0,0,0,0,0,0,0
D&N Haveli,"15 - Transplantation of Human Organs Act, 1994",2014,0,0,0,0,0,0,0,0,0,0,0,0,0,0,0
Daman & Diu,"15 - Transplantation of Human Organs Act, 1994",2014,0,0,0,0,0,0,0,0,0,0,0,0,0,0,0
Delhi UT,"15 - Transplantation of Human Organs Act, 1994",2014,0,0,0,0,0,0,0,0,0,0,0,0,0,0,0
Lakshadweep,"15 - Transplantation of Human Organs Act, 1994",2014,0,0,0,0,0,0,0,0,0,0,0,0,0,0,0
Puducherry,"15 - Transplantation of Human Organs Act, 1994",2014,0,0,0,0,0,0,0,0,0,0,0,0,0,0,0
Total (States),"15 - Transplantation of Human Organs Act, 1994",2014,0,0,0,0,0,0,0,0,0,0,0,0,0,0,0
Total (UTs),"15 - Transplantation of Human Organs Act, 1994",2014,0,0,0,0,0,0,0,0,0,0,0,0,0,0,0
Total (All India),"15 - Transplantation of Human Organs Act, 1994",2014,0,0,0,0,0,0,0,0,0,0,0,0,0,0,0
Andhra Pradesh,"16 - Child Labour (Prohibition & Regulation) Act, 1986",2014,0,0,0,0,0,0,0,0,0,0,0,0,0,0,0
Arunachal Pradesh,"16 - Child Labour (Prohibition & Regulation) Act, 1986",2014,0,0,0,0,0,0,0,0,0,0,0,0,0,0,0
Assam,"16 - Child Labour (Prohibition & Regulation) Act, 1986",2014,0,0,0,0,0,0,0,0,0,0,0,0,0,0,0
Bihar,"16 - Child Labour (Prohibition & Regulation) Act, 1986",2014,4,0,4,3,0,3,0,0,0,0,0,0,0,0,0
Chhattisgarh,"16 - Child Labour (Prohibition & Regulation) Act, 1986",2014,0,0,0,0,0,0,0,0,0,0,0,0,0,0,0
Goa,"16 - Child Labour (Prohibition & Regulation) Act, 1986",2014,0,0,0,0,0,0,0,0,0,0,0,0,0,0,0
Gujarat,"16 - Child Labour (Prohibition & Regulation) Act, 1986",2014,2,0,2,3,0,3,0,0,0,0,0,0,0,0,0
Haryana,"16 - Child Labour (Prohibition & Regulation) Act, 1986",2014,0,0,0,0,0,0,0,0,0,0,0,0,0,0,0
Himachal Pradesh,"16 - Child Labour (Prohibition & Regulation) Act, 1986",2014,0,0,0,2,1,3,0,0,0,0,0,0,0,0,0
Jammu & Kashmir,"16 - Child Labour (Prohibition & Regulation) Act, 1986",2014,0,0,0,0,0,0,0,0,0,0,0,0,0,0,0
Jharkhand,"16 - Child Labour (Prohibition & Regulation) Act, 1986",2014,0,0,0,0,0,0,0,0,0,0,0,0,0,0,0
Karnataka,"16 - Child Labour (Prohibition & Regulation) Act, 1986",2014,4,0,4,10,0,10,0,0,0,0,0,0,0,0,0
Kerala,"16 - Child Labour (Prohibition & Regulation) Act, 1986",2014,0,0,0,0,0,0,0,0,0,0,0,0,0,0,0
Madhya Pradesh,"16 - Child Labour (Prohibition & Regulation) Act, 1986",2014,4,0,4,4,0,4,1,0,1,1,0,1,0,0,0
Maharashtra,"16 - Child Labour (Prohibition & Regulation) Act, 1986",2014,74,1,75,75,2,77,4,0,4,1,0,1,3,0,3
Manipur,"16 - Child Labour (Prohibition & Regulation) Act, 1986",2014,0,0,0,0,0,0,0,0,0,0,0,0,0,0,0
Meghalaya,"16 - Child Labour (Prohibition & Regulation) Act, 1986",2014,0,0,0,0,0,0,0,0,0,0,0,0,0,0,0
Mizoram,"16 - Child Labour (Prohibition & Regulation) Act, 1986",2014,0,0,0,0,0,0,0,0,0,0,0,0,0,0,0
Nagaland,"16 - Child Labour (Prohibition & Regulation) Act, 1986",2014,0,0,0,0,0,0,0,0,0,0,0,0,0,0,0
Odisha,"16 - Child Labour (Prohibition & Regulation) Act, 1986",2014,3,1,4,3,1,4,0,0,0,0,0,0,0,0,0
Punjab,"16 - Child Labour (Prohibition & Regulation) Act, 1986",2014,0,0,0,0,0,0,0,0,0,0,0,0,0,0,0
Rajasthan,"16 - Child Labour (Prohibition & Regulation) Act, 1986",2014,5,0,5,5,0,5,0,0,0,0,0,0,0,0,0
Sikkim,"16 - Child Labour (Prohibition & Regulation) Act, 1986",2014,0,0,0,0,0,0,0,0,0,0,0,0,0,0,0
Tamil Nadu,"16 - Child Labour (Prohibition & Regulation) Act, 1986",2014,0,0,0,0,0,0,0,0,0,0,0,0,0,0,0
Telangana,"16 - Child Labour (Prohibition & Regulation) Act, 1986",2014,4,0,4,2,0,2,0,0,0,0,0,0,0,0,0
Tripura,"16 - Child Labour (Prohibition & Regulation) Act, 1986",2014,0,0,0,0,0,0,0,0,0,0,0,0,0,0,0
Uttar Pradesh,"16 - Child Labour (Prohibition & Regulation) Act, 1986",2014,5,0,5,5,0,5,0,0,0,0,0,0,0,0,0
Uttarakhand,"16 - Child Labour (Prohibition & Regulation) Act, 1986",2014,7,0,7,7,0,7,0,0,0,0,0,0,0,0,0
West Bengal,"16 - Child Labour (Prohibition & Regulation) Act, 1986",2014,7,0,7,5,0,5,0,0,0,0,0,0,0,0,0
A & N Islands,"16 - Child Labour (Prohibition & Regulation) Act, 1986",2014,0,0,0,0,0,0,0,0,0,0,0,0,0,0,0
Chandigarh,"16 - Child Labour (Prohibition & Regulation) Act, 1986",2014,0,0,0,0,0,0,0,0,0,0,0,0,0,0,0
D&N Haveli,"16 - Child Labour (Prohibition & Regulation) Act, 1986",2014,0,0,0,0,0,0,0,0,0,0,0,0,0,0,0
Daman & Diu,"16 - Child Labour (Prohibition & Regulation) Act, 1986",2014,0,0,0,0,0,0,0,0,0,0,0,0,0,0,0
Delhi UT,"16 - Child Labour (Prohibition & Regulation) Act, 1986",2014,34,1,35,80,2,82,5,0,5,1,0,1,4,0,4
Lakshadweep,"16 - Child Labour (Prohibition & Regulation) Act, 1986",2014,0,0,0,0,0,0,0,0,0,0,0,0,0,0,0
Puducherry,"16 - Child Labour (Prohibition & Regulation) Act, 1986",2014,0,0,0,0,0,0,0,0,0,0,0,0,0,0,0
Total (States),"16 - Child Labour (Prohibition & Regulation) Act, 1986",2014,119,2,121,124,4,128,5,0,5,2,0,2,3,0,3
Total (UTs),"16 - Child Labour (Prohibition & Regulation) Act, 1986",2014,34,1,35,80,2,82,5,0,5,1,0,1,4,0,4
Total (All India),"16 - Child Labour (Prohibition & Regulation) Act, 1986",2014,153,3,156,204,6,210,10,0,10,3,0,3,7,0,7
Andhra Pradesh,2 - Infanticide (Section 315 IPC),2014,3,0,3,3,0,3,1,0,1,0,0,0,1,0,1
Arunachal Pradesh,2 - Infanticide (Section 315 IPC),2014,0,0,0,0,0,0,0,0,0,0,0,0,0,0,0
Assam,2 - Infanticide (Section 315 IPC),2014,0,0,0,0,0,0,0,0,0,0,0,0,0,0,0
Bihar,2 - Infanticide (Section 315 IPC),2014,0,0,0,3,0,3,0,0,0,0,0,0,0,0,0
Chhattisgarh,2 - Infanticide (Section 315 IPC),2014,4,0,4,4,0,4,0,0,0,0,0,0,0,0,0
Goa,2 - Infanticide (Section 315 IPC),2014,0,0,0,1,0,1,0,0,0,0,0,0,0,0,0
Gujarat,2 - Infanticide (Section 315 IPC),2014,0,0,0,1,0,1,0,0,0,0,0,0,0,0,0
Haryana,2 - Infanticide (Section 315 IPC),2014,0,0,0,0,0,0,0,0,0,0,0,0,0,0,0
Himachal Pradesh,2 - Infanticide (Section 315 IPC),2014,0,0,0,0,0,0,0,0,0,0,0,0,0,0,0
Jammu & Kashmir,2 - Infanticide (Section 315 IPC),2014,0,0,0,0,0,0,0,0,0,0,0,0,0,0,0
Jharkhand,2 - Infanticide (Section 315 IPC),2014,2,0,2,0,0,0,0,0,0,0,0,0,0,0,0
Karnataka,2 - Infanticide (Section 315 IPC),2014,8,0,8,10,0,10,0,0,0,0,0,0,0,0,0
Kerala,2 - Infanticide (Section 315 IPC),2014,0,0,0,5,0,5,0,0,0,0,0,0,0,0,0
Madhya Pradesh,2 - Infanticide (Section 315 IPC),2014,3,0,3,38,2,40,9,2,11,4,0,4,5,2,7
Maharashtra,2 - Infanticide (Section 315 IPC),2014,6,4,10,39,12,51,4,0,4,0,0,0,4,0,4
Manipur,2 - Infanticide (Section 315 IPC),2014,0,0,0,0,0,0,0,0,0,0,0,0,0,0,0
Meghalaya,2 - Infanticide (Section 315 IPC),2014,0,0,0,1,0,1,0,0,0,0,0,0,0,0,0
Mizoram,2 - Infanticide (Section 315 IPC),2014,0,0,0,0,0,0,0,0,0,0,0,0,0,0,0
Nagaland,2 - Infanticide (Section 315 IPC),2014,0,0,0,0,0,0,0,0,0,0,0,0,0,0,0
Odisha,2 - Infanticide (Section 315 IPC),2014,0,0,0,3,0,3,0,0,0,0,0,0,0,0,0
Punjab,2 - Infanticide (Section 315 IPC),2014,4,1,5,3,0,3,1,0,1,0,0,0,1,0,1
Rajasthan,2 - Infanticide (Section 315 IPC),2014,9,0,9,4,0,4,0,0,0,0,0,0,0,0,0
Sikkim,2 - Infanticide (Section 315 IPC),2014,0,0,0,0,0,0,0,0,0,0,0,0,0,0,0
Tamil Nadu,2 - Infanticide (Section 315 IPC),2014,0,0,0,5,0,5,0,0,0,0,0,0,0,0,0
Telangana,2 - Infanticide (Section 315 IPC),2014,6,1,7,35,0,35,0,0,0,0,0,0,0,0,0
Tripura,2 - Infanticide (Section 315 IPC),2014,0,0,0,0,0,0,0,0,0,0,0,0,0,0,0
Uttar Pradesh,2 - Infanticide (Section 315 IPC),2014,25,0,25,166,1,167,42,0,42,25,0,25,17,0,17
Uttarakhand,2 - Infanticide (Section 315 IPC),2014,0,0,0,0,0,0,0,0,0,0,0,0,0,0,0
West Bengal,2 - Infanticide (Section 315 IPC),2014,0,0,0,4,0,4,0,0,0,0,0,0,0,0,0
A & N Islands,2 - Infanticide (Section 315 IPC),2014,0,0,0,0,0,0,0,0,0,0,0,0,0,0,0
Chandigarh,2 - Infanticide (Section 315 IPC),2014,0,0,0,0,0,0,0,0,0,0,0,0,0,0,0
D&N Haveli,2 - Infanticide (Section 315 IPC),2014,0,0,0,1,0,1,0,0,0,0,0,0,0,0,0
Daman & Diu,2 - Infanticide (Section 315 IPC),2014,0,0,0,0,0,0,0,0,0,0,0,0,0,0,0
Delhi UT,2 - Infanticide (Section 315 IPC),2014,3,0,3,1,0,1,0,0,0,0,0,0,0,0,0
Lakshadweep,2 - Infanticide (Section 315 IPC),2014,0,0,0,0,0,0,0,0,0,0,0,0,0,0,0
Puducherry,2 - Infanticide (Section 315 IPC),2014,0,0,0,0,0,0,0,0,0,0,0,0,0,0,0
Total (States),2 - Infanticide (Section 315 IPC),2014,70,6,76,325,15,340,57,2,59,29,0,29,28,2,30
Total (UTs),2 - Infanticide (Section 315 IPC),2014,3,0,3,2,0,2,0,0,0,0,0,0,0,0,0
Total (All India),2 - Infanticide (Section 315 IPC),2014,73,6,79,327,15,342,57,2,59,29,0,29,28,2,30
Andhra Pradesh,20 - Attempt to commit Murder u/s 307 IPC,2014,2,0,2,9,1,10,2,1,3,0,0,0,2,1,3
Arunachal Pradesh,20 - Attempt to commit Murder u/s 307 IPC,2014,10,0,10,72,0,72,0,0,0,0,0,0,0,0,0
Assam,20 - Attempt to commit Murder u/s 307 IPC,2014,326,6,332,549,2,551,37,0,37,8,0,8,29,0,29
Bihar,20 - Attempt to commit Murder u/s 307 IPC,2014,27,0,27,25,0,25,15,0,15,0,0,0,15,0,15
Chhattisgarh,20 - Attempt to commit Murder u/s 307 IPC,2014,263,7,270,532,32,564,171,13,184,81,6,87,90,7,97
Goa,20 - Attempt to commit Murder u/s 307 IPC,2014,2,0,2,3,0,3,0,0,0,0,0,0,0,0,0
Gujarat,20 - Attempt to commit Murder u/s 307 IPC,2014,83,7,90,448,7,455,18,0,18,2,0,2,16,0,16
Haryana,20 - Attempt to commit Murder u/s 307 IPC,2014,59,2,61,94,1,95,56,0,56,22,0,22,34,0,34
Himachal Pradesh,20 - Attempt to commit Murder u/s 307 IPC,2014,0,0,0,0,0,0,0,0,0,0,0,0,0,0,0
Jammu & Kashmir,20 - Attempt to commit Murder u/s 307 IPC,2014,4,0,4,5,0,5,0,0,0,0,0,0,0,0,0
Jharkhand,20 - Attempt to commit Murder u/s 307 IPC,2014,195,8,203,1312,4,1316,276,0,276,117,0,117,109,0,109
Karnataka,20 - Attempt to commit Murder u/s 307 IPC,2014,345,3,348,1190,4,1194,131,0,131,12,0,12,119,0,119
Kerala,20 - Attempt to commit Murder u/s 307 IPC,2014,23,1,24,194,1,195,0,0,0,0,0,0,0,0,0
Madhya Pradesh,20 - Attempt to commit Murder u/s 307 IPC,2014,46,0,46,68,0,68,3,0,3,2,0,2,1,0,1
Maharashtra,20 - Attempt to commit Murder u/s 307 IPC,2014,88,7,95,241,5,246,8,0,8,3,0,3,3,0,3
Manipur,20 - Attempt to commit Murder u/s 307 IPC,2014,0,0,0,0,0,0,0,0,0,0,0,0,0,0,0
Meghalaya,20 - Attempt to commit Murder u/s 307 IPC,2014,18,0,18,45,0,45,0,0,0,0,0,0,0,0,0
Mizoram,20 - Attempt to commit Murder u/s 307 IPC,2014,0,0,0,0,0,0,0,0,0,0,0,0,0,0,0
Nagaland,20 - Attempt to commit Murder u/s 307 IPC,2014,22,0,22,35,0,35,24,0,24,20,0,20,0,0,0
Odisha,20 - Attempt to commit Murder u/s 307 IPC,2014,4,0,4,4,0,4,0,0,0,0,0,0,0,0,0
Punjab,20 - Attempt to commit Murder u/s 307 IPC,2014,58,5,63,62,0,62,34,0,34,24,0,24,10,0,10
Rajasthan,20 - Attempt to commit Murder u/s 307 IPC,2014,82,16,98,83,16,99,12,3,15,7,0,7,5,3,8
Sikkim,20 - Attempt to commit Murder u/s 307 IPC,2014,9,0,9,5,0,5,0,0,0,0,0,0,0,0,0
Tamil Nadu,20 - Attempt to commit Murder u/s 307 IPC,2014,26,1,27,7,0,7,0,0,0,0,0,0,0,0,0
Telangana,20 - Attempt to commit Murder u/s 307 IPC,2014,513,26,539,499,17,516,297,14,311,34,5,39,229,9,238
Tripura,20 - Attempt to commit Murder u/s 307 IPC,2014,7,0,7,21,0,21,6,0,6,2,0,2,4,0,4
Uttar Pradesh,20 - Attempt to commit Murder u/s 307 IPC,2014,20,0,20,15,0,15,0,0,0,0,0,0,0,0,0
Uttarakhand,20 - Attempt to commit Murder u/s 307 IPC,2014,0,0,0,0,0,0,0,0,0,0,0,0,0,0,0
West Bengal,20 - Attempt to commit Murder u/s 307 IPC,2014,151,15,166,563,34,597,0,0,0,0,0,0,0,0,0
A & N Islands,20 - Attempt to commit Murder u/s 307 IPC,2014,0,0,0,3,0,3,0,0,0,0,0,0,0,0,0
Chandigarh,20 - Attempt to commit Murder u/s 307 IPC,2014,0,0,0,0,0,0,0,0,0,0,0,0,0,0,0
D&N Haveli,20 - Attempt to commit Murder u/s 307 IPC,2014,0,0,0,0,0,0,0,0,0,0,0,0,0,0,0
Daman & Diu,20 - Attempt to commit Murder u/s 307 IPC,2014,0,0,0,0,0,0,0,0,0,0,0,0,0,0,0
Delhi UT,20 - Attempt to commit Murder u/s 307 IPC,2014,14,0,14,3,0,3,0,0,0,0,0,0,0,0,0
Lakshadweep,20 - Attempt to commit Murder u/s 307 IPC,2014,0,0,0,0,0,0,0,0,0,0,0,0,0,0,0
Puducherry,20 - Attempt to commit Murder u/s 307 IPC,2014,1,0,1,1,0,1,0,0,0,0,0,0,0,0,0
Total (States),20 - Attempt to commit Murder u/s 307 IPC,2014,2383,104,2487,6081,124,6205,1090,31,1121,334,11,345,666,20,686
Total (UTs),20 - Attempt to commit Murder u/s 307 IPC,2014,15,0,15,7,0,7,0,0,0,0,0,0,0,0,0
Total (All India),20 - Attempt to commit Murder u/s 307 IPC,2014,2398,104,2502,6088,124,6212,1090,31,1121,334,11,345,666,20,686
Andhra Pradesh,22 - Other crimes committed against children,2014,390,20,410,578,38,616,144,16,160,20,2,22,124,14,138
Arunachal Pradesh,22 - Other crimes committed against children,2014,1,0,1,1,0,1,0,0,0,0,0,0,0,0,0
Assam,22 - Other crimes committed against children,2014,181,0,181,92,0,92,15,0,15,0,0,0,15,0,15
Bihar,22 - Other crimes committed against children,2014,104,0,104,164,0,164,5,0,5,2,0,2,3,0,3
Chhattisgarh,22 - Other crimes committed against children,2014,722,64,786,2669,74,2743,800,26,826,304,10,314,494,16,510
Goa,22 - Other crimes committed against children,2014,70,21,91,219,31,250,6,1,7,1,1,2,5,0,5
Gujarat,22 - Other crimes committed against children,2014,229,9,238,1066,14,1080,86,0,86,9,0,9,69,0,69
Haryana,22 - Other crimes committed against children,2014,227,6,233,325,9,334,174,3,177,34,1,35,140,2,142
Himachal Pradesh,22 - Other crimes committed against children,2014,6,2,8,97,6,103,16,0,16,2,0,2,14,0,14
Jammu & Kashmir,22 - Other crimes committed against children,2014,0,0,0,16,0,16,9,0,9,0,0,0,9,0,9
Jharkhand,22 - Other crimes committed against children,2014,34,3,37,72,0,72,17,0,17,7,0,7,10,0,10
Karnataka,22 - Other crimes committed against children,2014,463,6,469,490,6,496,117,0,117,33,0,33,82,0,82
Kerala,22 - Other crimes committed against children,2014,575,12,587,1945,11,1956,218,4,222,54,2,56,164,2,166
Madhya Pradesh,22 - Other crimes committed against children,2014,4898,184,5082,14584,276,14860,3395,102,3497,1334,14,1348,2028,88,2116
Maharashtra,22 - Other crimes committed against children,2014,1107,53,1160,8787,165,8952,303,4,307,74,0,74,226,4,230
Manipur,22 - Other crimes committed against children,2014,1,2,3,1,0,1,0,0,0,0,0,0,0,0,0
Meghalaya,22 - Other crimes committed against children,2014,9,0,9,21,0,21,0,0,0,0,0,0,0,0,0
Mizoram,22 - Other crimes committed against children,2014,7,0,7,15,0,15,11,0,11,11,0,11,0,0,0
Nagaland,22 - Other crimes committed against children,2014,0,0,0,0,0,0,0,0,0,0,0,0,0,0,0
Odisha,22 - Other crimes committed against children,2014,172,5,177,442,4,446,50,0,50,12,0,12,38,0,38
Punjab,22 - Other crimes committed against children,2014,57,4,61,57,4,61,14,1,15,5,0,5,9,1,10
Rajasthan,22 - Other crimes committed against children,2014,131,3,134,308,5,313,37,2,39,19,0,19,18,2,20
Sikkim,22 - Other crimes committed against children,2014,0,0,0,0,0,0,0,0,0,0,0,0,0,0,0
Tamil Nadu,22 - Other crimes committed against children,2014,324,10,334,325,1,326,94,0,94,37,0,37,57,0,57
Telangana,22 - Other crimes committed against children,2014,336,9,345,368,11,379,71,8,79,21,0,21,50,8,58
Tripura,22 - Other crimes committed against children,2014,4,0,4,12,0,12,4,0,4,1,0,1,3,0,3
Uttar Pradesh,22 - Other crimes committed against children,2014,389,1,390,3081,21,3102,451,2,453,234,2,236,202,0,202
Uttarakhand,22 - Other crimes committed against children,2014,13,0,13,73,1,74,11,1,12,5,1,6,6,0,6
West Bengal,22 - Other crimes committed against children,2014,245,6,251,217,5,222,21,0,21,5,0,5,16,0,16
A & N Islands,22 - Other crimes committed against children,2014,6,1,7,73,7,80,13,0,13,7,0,7,6,0,6
Chandigarh,22 - Other crimes committed against children,2014,14,0,14,27,0,27,18,0,18,8,0,8,10,0,10
D&N Haveli,22 - Other crimes committed against children,2014,0,0,0,4,0,4,0,0,0,0,0,0,0,0,0
Daman & Diu,22 - Other crimes committed against children,2014,0,0,0,0,0,0,0,0,0,0,0,0,0,0,0
Delhi UT,22 - Other crimes committed against children,2014,165,0,165,717,0,717,83,0,83,42,0,42,39,0,39
Lakshadweep,22 - Other crimes committed against children,2014,0,0,0,0,0,0,0,0,0,0,0,0,0,0,0
Puducherry,22 - Other crimes committed against children,2014,1,0,1,1,0,1,0,0,0,0,0,0,0,0,0
Total (States),22 - Other crimes committed against children,2014,10695,420,11115,36025,682,36707,6069,170,6239,2224,33,2257,3782,137,3919
Total (UTs),22 - Other crimes committed against children,2014,186,1,187,822,7,829,114,0,114,57,0,57,55,0,55
Total (All India),22 - Other crimes committed against children,2014,10881,421,11302,36847,689,37536,6183,170,6353,2281,33,2314,3837,137,3974
Andhra Pradesh,23 - Total crimes against Children,2014,2387,72,2459,3868,103,3971,885,35,920,57,2,59,827,33,860
Arunachal Pradesh,23 - Total crimes against Children,2014,119,5,124,218,3,221,4,0,4,1,0,1,3,0,3
Assam,23 - Total crimes against Children,2014,1451,36,1487,980,28,1008,94,0,94,23,0,23,71,0,71
Bihar,23 - Total crimes against Children,2014,2406,0,2406,8327,0,8327,661,0,661,74,0,74,584,0,584
Chhattisgarh,23 - Total crimes against Children,2014,3727,184,3911,9419,221,9640,2068,41,2109,764,16,780,1289,25,1314
Goa,23 - Total crimes against Children,2014,225,31,256,678,59,737,24,1,25,9,1,10,15,0,15
Gujarat,23 - Total crimes against Children,2014,3064,147,3211,11876,290,12166,708,11,719,50,4,54,613,7,620
Haryana,23 - Total crimes against Children,2014,2004,42,2046,3841,50,3891,1563,16,1579,281,4,285,1282,12,1294
Himachal Pradesh,23 - Total crimes against Children,2014,379,25,404,1211,51,1262,156,2,158,39,0,39,116,2,118
Jammu & Kashmir,23 - Total crimes against Children,2014,187,3,190,609,4,613,80,0,80,2,0,2,78,0,78
Jharkhand,23 - Total crimes against Children,2014,498,11,509,1654,4,1658,343,0,343,151,0,151,142,0,142
Karnataka,23 - Total crimes against Children,2014,3356,93,3449,5475,102,5577,609,8,617,87,0,87,516,8,524
Kerala,23 - Total crimes against Children,2014,2637,77,2714,8000,103,8103,474,13,487,127,4,131,347,8,355
Madhya Pradesh,23 - Total crimes against Children,2014,13806,316,14122,31850,455,32305,6874,152,7026,2557,29,2586,4274,123,4397
Maharashtra,23 - Total crimes against Children,2014,7995,343,8338,36086,971,37057,1739,63,1802,234,2,236,1487,60,1547
Manipur,23 - Total crimes against Children,2014,54,2,56,34,0,34,0,0,0,0,0,0,0,0,0
Meghalaya,23 - Total crimes against Children,2014,183,0,183,491,0,491,7,0,7,7,0,7,0,0,0
Mizoram,23 - Total crimes against Children,2014,152,1,153,177,1,178,54,0,54,50,0,50,3,0,3
Nagaland,23 - Total crimes against Children,2014,44,1,45,46,1,47,28,0,28,24,0,24,0,0,0
Odisha,23 - Total crimes against Children,2014,1802,48,1850,3743,57,3800,247,1,248,31,0,31,216,1,217
Punjab,23 - Total crimes against Children,2014,1624,59,1683,2135,43,2178,596,16,612,223,0,223,373,16,389
Rajasthan,23 - Total crimes against Children,2014,2578,82,2660,7101,142,7243,961,36,997,366,8,374,572,28,600
Sikkim,23 - Total crimes against Children,2014,83,0,83,71,0,71,22,0,22,3,0,3,18,0,18
Tamil Nadu,23 - Total crimes against Children,2014,2559,152,2711,4221,114,4335,1129,76,1205,603,59,662,526,17,543
Telangana,23 - Total crimes against Children,2014,3196,81,3277,4381,83,4464,951,36,987,103,5,108,809,31,840
Tripura,23 - Total crimes against Children,2014,330,5,335,675,8,683,115,0,115,24,0,24,90,0,90
Uttar Pradesh,23 - Total crimes against Children,2014,25420,599,26019,45912,898,46810,4928,203,5131,2451,93,2544,2364,110,2474
Uttarakhand,23 - Total crimes against Children,2014,357,5,362,606,6,612,98,1,99,45,1,46,53,0,53
West Bengal,23 - Total crimes against Children,2014,5099,167,5266,7738,193,7931,648,7,655,36,0,36,604,7,611
A & N Islands,23 - Total crimes against Children,2014,49,8,57,322,13,335,33,0,33,13,0,13,20,0,20
Chandigarh,23 - Total crimes against Children,2014,133,1,134,302,1,303,138,1,139,50,1,51,88,0,88
D&N Haveli,23 - Total crimes against Children,2014,6,1,7,47,1,48,0,0,0,0,0,0,0,0,0
Daman & Diu,23 - Total crimes against Children,2014,4,2,6,20,1,21,3,0,3,1,0,1,2,0,2
Delhi UT,23 - Total crimes against Children,2014,2878,31,2909,8682,119,8801,949,5,954,363,5,368,565,0,565
Lakshadweep,23 - Total crimes against Children,2014,3,0,3,3,0,3,0,0,0,0,0,0,0,0,0
Puducherry,23 - Total crimes against Children,2014,29,6,35,48,8,56,0,0,0,0,0,0,0,0,0
Total (States),23 - Total crimes against Children,2014,87722,2587,90309,201423,3990,205413,26066,718,26784,8422,228,8650,17272,488,17760
Total (UTs),23 - Total crimes against Children,2014,3102,49,3151,9424,143,9567,1123,6,1129,427,6,433,675,0,675
Total (All India),23 - Total crimes against Children,2014,90824,2636,93460,210847,4133,214980,27189,724,27913,8849,234,9083,17947,488,18435
Andhra Pradesh,3 - Rape,2014,617,21,638,985,15,1000,235,1,236,13,0,13,222,1,223
Arunachal Pradesh,3 - Rape,2014,42,0,42,71,0,71,2,0,2,1,0,1,1,0,1
Assam,3 - Rape,2014,111,0,111,60,0,60,7,0,7,2,0,2,5,0,5
Bihar,3 - Rape,2014,121,0,121,548,0,548,72,0,72,16,0,16,56,0,56
Chhattisgarh,3 - Rape,2014,885,5,890,1940,5,1945,354,0,354,111,0,111,240,0,240
Goa,3 - Rape,2014,67,3,70,244,9,253,10,0,10,2,0,2,8,0,8
Gujarat,3 - Rape,2014,384,13,397,959,15,974,48,0,48,5,0,5,41,0,41
Haryana,3 - Rape,2014,487,15,502,1077,15,1092,559,3,562,102,0,102,457,3,460
Himachal Pradesh,3 - Rape,2014,158,4,162,496,11,507,73,2,75,32,0,32,41,2,43
Jammu & Kashmir,3 - Rape,2014,37,0,37,80,0,80,19,0,19,1,0,1,18,0,18
Jharkhand,3 - Rape,2014,100,0,100,97,0,97,23,0,23,11,0,11,12,0,12
Karnataka,3 - Rape,2014,798,9,807,1252,9,1261,117,3,120,22,0,22,95,3,98
Kerala,3 - Rape,2014,836,12,848,2914,13,2927,110,2,112,38,0,38,72,2,74
Madhya Pradesh,3 - Rape,2014,2883,32,2915,7997,39,8036,1964,13,1977,654,4,658,1309,9,1318
Maharashtra,3 - Rape,2014,1951,67,2018,9619,98,9717,379,5,384,63,2,65,312,3,315
Manipur,3 - Rape,2014,22,0,22,32,0,32,0,0,0,0,0,0,0,0,0
Meghalaya,3 - Rape,2014,69,0,69,293,0,293,7,0,7,7,0,7,0,0,0
Mizoram,3 - Rape,2014,90,0,90,118,0,118,27,0,27,23,0,23,3,0,3
Nagaland,3 - Rape,2014,9,0,9,5,0,5,1,0,1,1,0,1,0,0,0
Odisha,3 - Rape,2014,712,3,715,1718,2,1720,111,0,111,15,0,15,96,0,96
Punjab,3 - Rape,2014,542,11,553,633,7,640,285,2,287,104,0,104,181,2,183
Rajasthan,3 - Rape,2014,761,14,775,2660,22,2682,385,12,397,137,3,140,232,9,241
Sikkim,3 - Rape,2014,36,0,36,37,0,37,19,0,19,2,0,2,17,0,17
Tamil Nadu,3 - Rape,2014,6,0,6,995,2,997,214,2,216,60,0,60,154,2,156
Telangana,3 - Rape,2014,879,4,883,1384,3,1387,203,0,203,32,0,32,171,0,171
Tripura,3 - Rape,2014,119,0,119,190,1,191,39,0,39,8,0,8,31,0,31
Uttar Pradesh,3 - Rape,2014,2343,3,2346,6473,2,6475,766,0,766,372,0,372,353,0,353
Uttarakhand,3 - Rape,2014,93,3,96,141,3,144,30,0,30,13,0,13,17,0,17
West Bengal,3 - Rape,2014,0,0,0,0,0,0,0,0,0,0,0,0,0,0,0
A & N Islands,3 - Rape,2014,21,3,24,125,3,128,5,0,5,1,0,1,4,0,4
Chandigarh,3 - Rape,2014,34,0,34,60,0,60,31,0,31,13,0,13,18,0,18
D&N Haveli,3 - Rape,2014,2,1,3,6,1,7,0,0,0,0,0,0,0,0,0
Daman & Diu,3 - Rape,2014,1,0,1,15,0,15,3,0,3,1,0,1,2,0,2
Delhi UT,3 - Rape,2014,930,3,933,3088,14,3102,387,0,387,144,0,144,239,0,239
Lakshadweep,3 - Rape,2014,0,0,0,0,0,0,0,0,0,0,0,0,0,0,0
Puducherry,3 - Rape,2014,3,0,3,6,0,6,0,0,0,0,0,0,0,0,0
Total (States),3 - Rape,2014,15158,219,15377,43018,271,43289,6059,45,6104,1847,9,1856,4144,36,4180
Total (UTs),3 - Rape,2014,991,7,998,3300,18,3318,426,0,426,159,0,159,263,0,263
Total (All India),3 - Rape,2014,16149,226,16375,46318,289,46607,6485,45,6530,2006,9,2015,4407,36,4443
Andhra Pradesh,5 - Insult to the Modesty of Women (Girls Children) (Section 509 IPC),2014,127,0,127,233,0,233,24,0,24,8,0,8,16,0,16
Arunachal Pradesh,5 - Insult to the Modesty of Women (Girls Children) (Section 509 IPC),2014,0,0,0,0,0,0,0,0,0,0,0,0,0,0,0
Assam,5 - Insult to the Modesty of Women (Girls Children) (Section 509 IPC),2014,0,0,0,0,0,0,0,0,0,0,0,0,0,0,0
Bihar,5 - Insult to the Modesty of Women (Girls Children) (Section 509 IPC),2014,0,0,0,0,0,0,0,0,0,0,0,0,0,0,0
Chhattisgarh,5 - Insult to the Modesty of Women (Girls Children) (Section 509 IPC),2014,15,0,15,199,0,199,91,0,91,44,0,44,47,0,47
Goa,5 - Insult to the Modesty of Women (Girls Children) (Section 509 IPC),2014,1,0,1,7,0,7,0,0,0,0,0,0,0,0,0
Gujarat,5 - Insult to the Modesty of Women (Girls Children) (Section 509 IPC),2014,4,0,4,4,0,4,0,0,0,0,0,0,0,0,0
Haryana,5 - Insult to the Modesty of Women (Girls Children) (Section 509 IPC),2014,2,0,2,2,0,2,1,0,1,0,0,0,1,0,1
Himachal Pradesh,5 - Insult to the Modesty of Women (Girls Children) (Section 509 IPC),2014,0,0,0,0,0,0,0,0,0,0,0,0,0,0,0
Jammu & Kashmir,5 - Insult to the Modesty of Women (Girls Children) (Section 509 IPC),2014,1,0,1,1,0,1,0,0,0,0,0,0,0,0,0
Jharkhand,5 - Insult to the Modesty of Women (Girls Children) (Section 509 IPC),2014,0,0,0,0,0,0,0,0,0,0,0,0,0,0,0
Karnataka,5 - Insult to the Modesty of Women (Girls Children) (Section 509 IPC),2014,0,0,0,0,0,0,0,0,0,0,0,0,0,0,0
Kerala,5 - Insult to the Modesty of Women (Girls Children) (Section 509 IPC),2014,2,0,2,6,0,6,0,0,0,0,0,0,0,0,0
Madhya Pradesh,5 - Insult to the Modesty of Women (Girls Children) (Section 509 IPC),2014,77,0,77,79,0,79,3,0,3,0,0,0,3,0,3
Maharashtra,5 - Insult to the Modesty of Women (Girls Children) (Section 509 IPC),2014,78,0,78,325,0,325,20,0,20,1,0,1,19,0,19
Manipur,5 - Insult to the Modesty of Women (Girls Children) (Section 509 IPC),2014,0,0,0,0,0,0,0,0,0,0,0,0,0,0,0
Meghalaya,5 - Insult to the Modesty of Women (Girls Children) (Section 509 IPC),2014,2,0,2,1,0,1,0,0,0,0,0,0,0,0,0
Mizoram,5 - Insult to the Modesty of Women (Girls Children) (Section 509 IPC),2014,0,0,0,0,0,0,0,0,0,0,0,0,0,0,0
Nagaland,5 - Insult to the Modesty of Women (Girls Children) (Section 509 IPC),2014,0,0,0,0,0,0,0,0,0,0,0,0,0,0,0
Odisha,5 - Insult to the Modesty of Women (Girls Children) (Section 509 IPC),2014,39,0,39,38,0,38,5,0,5,1,0,1,4,0,4
Punjab,5 - Insult to the Modesty of Women (Girls Children) (Section 509 IPC),2014,0,0,0,1,0,1,0,0,0,0,0,0,0,0,0
Rajasthan,5 - Insult to the Modesty of Women (Girls Children) (Section 509 IPC),2014,1,0,1,1,0,1,0,0,0,0,0,0,0,0,0
Sikkim,5 - Insult to the Modesty of Women (Girls Children) (Section 509 IPC),2014,0,0,0,0,0,0,0,0,0,0,0,0,0,0,0
Tamil Nadu,5 - Insult to the Modesty of Women (Girls Children) (Section 509 IPC),2014,8,0,8,6,0,6,0,0,0,0,0,0,0,0,0
Telangana,5 - Insult to the Modesty of Women (Girls Children) (Section 509 IPC),2014,99,0,99,99,0,99,30,0,30,0,0,0,30,0,30
Tripura,5 - Insult to the Modesty of Women (Girls Children) (Section 509 IPC),2014,0,0,0,0,0,0,0,0,0,0,0,0,0,0,0
Uttar Pradesh,5 - Insult to the Modesty of Women (Girls Children) (Section 509 IPC),2014,4,0,4,2,0,2,0,0,0,0,0,0,0,0,0
Uttarakhand,5 - Insult to the Modesty of Women (Girls Children) (Section 509 IPC),2014,0,0,0,0,0,0,0,0,0,0,0,0,0,0,0
West Bengal,5 - Insult to the Modesty of Women (Girls Children) (Section 509 IPC),2014,14,0,14,11,0,11,4,0,4,2,0,2,2,0,2
A & N Islands,5 - Insult to the Modesty of Women (Girls Children) (Section 509 IPC),2014,0,0,0,8,0,8,0,0,0,0,0,0,0,0,0
Chandigarh,5 - Insult to the Modesty of Women (Girls Children) (Section 509 IPC),2014,0,0,0,6,0,6,3,0,3,0,0,0,3,0,3
D&N Haveli,5 - Insult to the Modesty of Women (Girls Children) (Section 509 IPC),2014,0,0,0,0,0,0,0,0,0,0,0,0,0,0,0
Daman & Diu,5 - Insult to the Modesty of Women (Girls Children) (Section 509 IPC),2014,0,0,0,0,0,0,0,0,0,0,0,0,0,0,0
Delhi UT,5 - Insult to the Modesty of Women (Girls Children) (Section 509 IPC),2014,56,4,60,85,0,85,11,0,11,1,0,1,10,0,10
Lakshadweep,5 - Insult to the Modesty of Women (Girls Children) (Section 509 IPC),2014,0,0,0,0,0,0,0,0,0,0,0,0,0,0,0
Puducherry,5 - Insult to the Modesty of Women (Girls Children) (Section 509 IPC),2014,0,0,0,0,0,0,0,0,0,0,0,0,0,0,0
Total (States),5 - Insult to the Modesty of Women (Girls Children) (Section 509 IPC),2014,474,0,474,1015,0,1015,178,0,178,56,0,56,122,0,122
Total (UTs),5 - Insult to the Modesty of Women (Girls Children) (Section 509 IPC),2014,56,4,60,99,0,99,14,0,14,1,0,1,13,0,13
Total (All India),5 - Insult to the Modesty of Women (Girls Children) (Section 509 IPC),2014,530,4,534,1114,0,1114,192,0,192,57,0,57,135,0,135
Andhra Pradesh,7 - Foeticide (Section 315 and 316 IPC),2014,0,0,0,0,0,0,0,0,0,0,0,0,0,0,0
Arunachal Pradesh,7 - Foeticide (Section 315 and 316 IPC),2014,0,0,0,0,0,0,0,0,0,0,0,0,0,0,0
Assam,7 - Foeticide (Section 315 and 316 IPC),2014,0,0,0,0,0,0,0,0,0,0,0,0,0,0,0
Bihar,7 - Foeticide (Section 315 and 316 IPC),2014,0,0,0,13,0,13,2,0,2,0,0,0,2,0,2
Chhattisgarh,7 - Foeticide (Section 315 and 316 IPC),2014,0,0,0,1,0,1,0,0,0,0,0,0,0,0,0
Goa,7 - Foeticide (Section 315 and 316 IPC),2014,0,0,0,0,0,0,0,0,0,0,0,0,0,0,0
Gujarat,7 - Foeticide (Section 315 and 316 IPC),2014,0,0,0,0,0,0,0,0,0,0,0,0,0,0,0
Haryana,7 - Foeticide (Section 315 and 316 IPC),2014,2,0,2,8,0,8,6,0,6,0,0,0,6,0,6
Himachal Pradesh,7 - Foeticide (Section 315 and 316 IPC),2014,0,0,0,0,0,0,0,0,0,0,0,0,0,0,0
Jammu & Kashmir,7 - Foeticide (Section 315 and 316 IPC),2014,0,0,0,1,0,1,1,0,1,0,0,0,1,0,1
Jharkhand,7 - Foeticide (Section 315 and 316 IPC),2014,1,0,1,1,0,1,1,0,1,0,0,0,1,0,1
Karnataka,7 - Foeticide (Section 315 and 316 IPC),2014,0,0,0,1,0,1,0,0,0,0,0,0,0,0,0
Kerala,7 - Foeticide (Section 315 and 316 IPC),2014,0,0,0,1,0,1,0,0,0,0,0,0,0,0,0
Madhya Pradesh,7 - Foeticide (Section 315 and 316 IPC),2014,6,2,8,22,4,26,6,1,7,1,0,1,5,1,6
Maharashtra,7 - Foeticide (Section 315 and 316 IPC),2014,4,1,5,60,16,76,4,10,14,0,0,0,4,10,14
Manipur,7 - Foeticide (Section 315 and 316 IPC),2014,0,0,0,0,0,0,0,0,0,0,0,0,0,0,0
Meghalaya,7 - Foeticide (Section 315 and 316 IPC),2014,0,0,0,0,0,0,0,0,0,0,0,0,0,0,0
Mizoram,7 - Foeticide (Section 315 and 316 IPC),2014,0,0,0,0,0,0,0,0,0,0,0,0,0,0,0
Nagaland,7 - Foeticide (Section 315 and 316 IPC),2014,0,0,0,0,0,0,0,0,0,0,0,0,0,0,0
Odisha,7 - Foeticide (Section 315 and 316 IPC),2014,0,0,0,4,0,4,0,0,0,0,0,0,0,0,0
Punjab,7 - Foeticide (Section 315 and 316 IPC),2014,2,0,2,6,0,6,2,0,2,1,0,1,1,0,1
Rajasthan,7 - Foeticide (Section 315 and 316 IPC),2014,1,3,4,32,5,37,13,0,13,0,0,0,13,0,13
Sikkim,7 - Foeticide (Section 315 and 316 IPC),2014,0,0,0,0,0,0,0,0,0,0,0,0,0,0,0
Tamil Nadu,7 - Foeticide (Section 315 and 316 IPC),2014,0,0,0,0,0,0,0,0,0,0,0,0,0,0,0
Telangana,7 - Foeticide (Section 315 and 316 IPC),2014,3,0,3,7,0,7,2,0,2,0,0,0,2,0,2
Tripura,7 - Foeticide (Section 315 and 316 IPC),2014,0,0,0,0,0,0,0,0,0,0,0,0,0,0,0
Uttar Pradesh,7 - Foeticide (Section 315 and 316 IPC),2014,21,0,21,72,4,76,21,2,23,4,0,4,17,2,19
Uttarakhand,7 - Foeticide (Section 315 and 316 IPC),2014,1,0,1,2,0,2,2,0,2,0,0,0,2,0,2
West Bengal,7 - Foeticide (Section 315 and 316 IPC),2014,0,0,0,6,0,6,0,0,0,0,0,0,0,0,0
A & N Islands,7 - Foeticide (Section 315 and 316 IPC),2014,0,0,0,3,0,3,0,0,0,0,0,0,0,0,0
Chandigarh,7 - Foeticide (Section 315 and 316 IPC),2014,0,0,0,0,0,0,0,0,0,0,0,0,0,0,0
D&N Haveli,7 - Foeticide (Section 315 and 316 IPC),2014,0,0,0,0,0,0,0,0,0,0,0,0,0,0,0
Daman & Diu,7 - Foeticide (Section 315 and 316 IPC),2014,0,0,0,0,0,0,0,0,0,0,0,0,0,0,0
Delhi UT,7 - Foeticide (Section 315 and 316 IPC),2014,1,0,1,3,0,3,1,0,1,1,0,1,0,0,0
Lakshadweep,7 - Foeticide (Section 315 and 316 IPC),2014,0,0,0,0,0,0,0,0,0,0,0,0,0,0,0
Puducherry,7 - Foeticide (Section 315 and 316 IPC),2014,0,0,0,0,0,0,0,0,0,0,0,0,0,0,0
Total (States),7 - Foeticide (Section 315 and 316 IPC),2014,41,6,47,237,29,266,60,13,73,6,0,6,54,13,67
Total (UTs),7 - Foeticide (Section 315 and 316 IPC),2014,1,0,1,6,0,6,1,0,1,1,0,1,0,0,0
Total (All India),7 - Foeticide (Section 315 and 316 IPC),2014,42,6,48,243,29,272,61,13,74,7,0,7,54,13,67
Andhra Pradesh,8 - Abetment of Suicide of child (Section 305 IPC),2014,4,1,5,22,1,23,7,0,7,0,0,0,7,0,7
Arunachal Pradesh,8 - Abetment of Suicide of child (Section 305 IPC),2014,0,1,1,0,0,0,0,0,0,0,0,0,0,0,0
Assam,8 - Abetment of Suicide of child (Section 305 IPC),2014,0,0,0,0,0,0,0,0,0,0,0,0,0,0,0
Bihar,8 - Abetment of Suicide of child (Section 305 IPC),2014,0,0,0,0,0,0,0,0,0,0,0,0,0,0,0
Chhattisgarh,8 - Abetment of Suicide of child (Section 305 IPC),2014,1,0,1,3,0,3,0,0,0,0,0,0,0,0,0
Goa,8 - Abetment of Suicide of child (Section 305 IPC),2014,0,0,0,6,0,6,0,0,0,0,0,0,0,0,0
Gujarat,8 - Abetment of Suicide of child (Section 305 IPC),2014,0,0,0,6,0,6,6,0,6,0,0,0,6,0,6
Haryana,8 - Abetment of Suicide of child (Section 305 IPC),2014,2,0,2,9,0,9,5,0,5,0,0,0,5,0,5
Himachal Pradesh,8 - Abetment of Suicide of child (Section 305 IPC),2014,2,1,3,3,1,4,0,0,0,0,0,0,0,0,0
Jammu & Kashmir,8 - Abetment of Suicide of child (Section 305 IPC),2014,0,0,0,0,0,0,0,0,0,0,0,0,0,0,0
Jharkhand,8 - Abetment of Suicide of child (Section 305 IPC),2014,0,0,0,0,0,0,0,0,0,0,0,0,0,0,0
Karnataka,8 - Abetment of Suicide of child (Section 305 IPC),2014,0,0,0,0,0,0,0,0,0,0,0,0,0,0,0
Kerala,8 - Abetment of Suicide of child (Section 305 IPC),2014,4,0,4,12,0,12,0,0,0,0,0,0,0,0,0
Madhya Pradesh,8 - Abetment of Suicide of child (Section 305 IPC),2014,7,0,7,70,3,73,22,3,25,3,0,3,19,3,22
Maharashtra,8 - Abetment of Suicide of child (Section 305 IPC),2014,18,2,20,134,8,142,19,0,19,0,0,0,19,0,19
Manipur,8 - Abetment of Suicide of child (Section 305 IPC),2014,0,0,0,0,0,0,0,0,0,0,0,0,0,0,0
Meghalaya,8 - Abetment of Suicide of child (Section 305 IPC),2014,0,0,0,0,0,0,0,0,0,0,0,0,0,0,0
Mizoram,8 - Abetment of Suicide of child (Section 305 IPC),2014,0,0,0,0,0,0,0,0,0,0,0,0,0,0,0
Nagaland,8 - Abetment of Suicide of child (Section 305 IPC),2014,0,0,0,0,0,0,0,0,0,0,0,0,0,0,0
Odisha,8 - Abetment of Suicide of child (Section 305 IPC),2014,0,0,0,6,0,6,0,0,0,0,0,0,0,0,0
Punjab,8 - Abetment of Suicide of child (Section 305 IPC),2014,0,0,0,0,0,0,0,0,0,0,0,0,0,0,0
Rajasthan,8 - Abetment of Suicide of child (Section 305 IPC),2014,0,0,0,1,0,1,0,0,0,0,0,0,0,0,0
Sikkim,8 - Abetment of Suicide of child (Section 305 IPC),2014,0,0,0,0,0,0,0,0,0,0,0,0,0,0,0
Tamil Nadu,8 - Abetment of Suicide of child (Section 305 IPC),2014,1,0,1,7,0,7,2,0,2,0,0,0,2,0,2
Telangana,8 - Abetment of Suicide of child (Section 305 IPC),2014,4,0,4,29,0,29,14,0,14,1,0,1,13,0,13
Tripura,8 - Abetment of Suicide of child (Section 305 IPC),2014,0,0,0,0,0,0,0,0,0,0,0,0,0,0,0
Uttar Pradesh,8 - Abetment of Suicide of child (Section 305 IPC),2014,1,0,1,156,0,156,35,0,35,17,0,17,18,0,18
Uttarakhand,8 - Abetment of Suicide of child (Section 305 IPC),2014,0,0,0,0,0,0,0,0,0,0,0,0,0,0,0
West Bengal,8 - Abetment of Suicide of child (Section 305 IPC),2014,6,0,6,18,0,18,1,0,1,0,0,0,1,0,1
A & N Islands,8 - Abetment of Suicide of child (Section 305 IPC),2014,0,0,0,0,0,0,0,0,0,0,0,0,0,0,0
Chandigarh,8 - Abetment of Suicide of child (Section 305 IPC),2014,0,0,0,0,0,0,0,0,0,0,0,0,0,0,0
D&N Haveli,8 - Abetment of Suicide of child (Section 305 IPC),2014,0,0,0,0,0,0,0,0,0,0,0,0,0,0,0
Daman & Diu,8 - Abetment of Suicide of child (Section 305 IPC),2014,0,1,1,0,1,1,0,0,0,0,0,0,0,0,0
Delhi UT,8 - Abetment of Suicide of child (Section 305 IPC),2014,0,0,0,0,0,0,0,0,0,0,0,0,0,0,0
Lakshadweep,8 - Abetment of Suicide of child (Section 305 IPC),2014,0,0,0,0,0,0,0,0,0,0,0,0,0,0,0
Puducherry,8 - Abetment of Suicide of child (Section 305 IPC),2014,0,0,0,0,0,0,0,0,0,0,0,0,0,0,0
Total (States),8 - Abetment of Suicide of child (Section 305 IPC),2014,50,5,55,482,13,495,111,3,114,21,0,21,90,3,93
Total (UTs),8 - Abetment of Suicide of child (Section 305 IPC),2014,0,1,1,0,1,1,0,0,0,0,0,0,0,0,0
Total (All India),8 - Abetment of Suicide of child (Section 305 IPC),2014,50,6,56,482,14,496,111,3,114,21,0,21,90,3,93
Andhra Pradesh,9 - Exposure and Abandonment (Section 317 IPC),2014,24,0,24,9,0,9,3,0,3,0,0,0,3,0,3
Arunachal Pradesh,9 - Exposure and Abandonment (Section 317 IPC),2014,0,0,0,0,0,0,0,0,0,0,0,0,0,0,0
Assam,9 - Exposure and Abandonment (Section 317 IPC),2014,0,0,0,0,0,0,0,0,0,0,0,0,0,0,0
Bihar,9 - Exposure and Abandonment (Section 317 IPC),2014,1,0,1,6,0,6,0,0,0,0,0,0,0,0,0
Chhattisgarh,9 - Exposure and Abandonment (Section 317 IPC),2014,0,1,1,3,3,6,0,0,0,0,0,0,0,0,0
Goa,9 - Exposure and Abandonment (Section 317 IPC),2014,0,0,0,2,2,4,0,0,0,0,0,0,0,0,0
Gujarat,9 - Exposure and Abandonment (Section 317 IPC),2014,12,9,21,74,16,90,0,0,0,0,0,0,0,0,0
Haryana,9 - Exposure and Abandonment (Section 317 IPC),2014,2,0,2,13,1,14,6,1,7,0,0,0,6,1,7
Himachal Pradesh,9 - Exposure and Abandonment (Section 317 IPC),2014,0,2,2,0,3,3,0,0,0,0,0,0,0,0,0
Jammu & Kashmir,9 - Exposure and Abandonment (Section 317 IPC),2014,3,1,4,4,1,5,0,0,0,0,0,0,0,0,0
Jharkhand,9 - Exposure and Abandonment (Section 317 IPC),2014,0,0,0,0,0,0,0,0,0,0,0,0,0,0,0
Karnataka,9 - Exposure and Abandonment (Section 317 IPC),2014,25,12,37,12,11,23,0,0,0,0,0,0,0,0,0
Kerala,9 - Exposure and Abandonment (Section 317 IPC),2014,2,1,3,13,2,15,0,0,0,0,0,0,0,0,0
Madhya Pradesh,9 - Exposure and Abandonment (Section 317 IPC),2014,14,17,31,45,34,79,3,13,16,2,5,7,1,8,9
Maharashtra,9 - Exposure and Abandonment (Section 317 IPC),2014,90,17,107,527,133,660,23,11,34,0,0,0,22,11,33
Manipur,9 - Exposure and Abandonment (Section 317 IPC),2014,0,0,0,0,0,0,0,0,0,0,0,0,0,0,0
Meghalaya,9 - Exposure and Abandonment (Section 317 IPC),2014,0,0,0,0,0,0,0,0,0,0,0,0,0,0,0
Mizoram,9 - Exposure and Abandonment (Section 317 IPC),2014,0,0,0,0,0,0,0,0,0,0,0,0,0,0,0
Nagaland,9 - Exposure and Abandonment (Section 317 IPC),2014,0,0,0,0,0,0,0,0,0,0,0,0,0,0,0
Odisha,9 - Exposure and Abandonment (Section 317 IPC),2014,0,0,0,0,0,0,0,0,0,0,0,0,0,0,0
Punjab,9 - Exposure and Abandonment (Section 317 IPC),2014,4,0,4,1,0,1,0,0,0,0,0,0,0,0,0
Rajasthan,9 - Exposure and Abandonment (Section 317 IPC),2014,9,12,21,47,28,75,6,7,13,2,2,4,4,5,9
Sikkim,9 - Exposure and Abandonment (Section 317 IPC),2014,0,0,0,0,0,0,0,0,0,0,0,0,0,0,0
Tamil Nadu,9 - Exposure and Abandonment (Section 317 IPC),2014,1,0,1,2,1,3,2,1,3,0,0,0,2,1,3
Telangana,9 - Exposure and Abandonment (Section 317 IPC),2014,16,0,16,36,0,36,7,0,7,0,0,0,7,0,7
Tripura,9 - Exposure and Abandonment (Section 317 IPC),2014,0,0,0,0,0,0,0,0,0,0,0,0,0,0,0
Uttar Pradesh,9 - Exposure and Abandonment (Section 317 IPC),2014,0,0,0,4,0,4,4,0,4,1,0,1,3,0,3
Uttarakhand,9 - Exposure and Abandonment (Section 317 IPC),2014,0,0,0,0,0,0,0,0,0,0,0,0,0,0,0
West Bengal,9 - Exposure and Abandonment (Section 317 IPC),2014,0,0,0,6,0,6,0,0,0,0,0,0,0,0,0
A & N Islands,9 - Exposure and Abandonment (Section 317 IPC),2014,0,0,0,1,1,2,0,0,0,0,0,0,0,0,0
Chandigarh,9 - Exposure and Abandonment (Section 317 IPC),2014,0,0,0,2,0,2,0,0,0,0,0,0,0,0,0
D&N Haveli,9 - Exposure and Abandonment (Section 317 IPC),2014,0,0,0,0,0,0,0,0,0,0,0,0,0,0,0
Daman & Diu,9 - Exposure and Abandonment (Section 317 IPC),2014,1,1,2,0,0,0,0,0,0,0,0,0,0,0,0
Delhi UT,9 - Exposure and Abandonment (Section 317 IPC),2014,0,0,0,27,18,45,0,0,0,0,0,0,0,0,0
Lakshadweep,9 - Exposure and Abandonment (Section 317 IPC),2014,0,0,0,0,0,0,0,0,0,0,0,0,0,0,0
Puducherry,9 - Exposure and Abandonment (Section 317 IPC),2014,0,0,0,0,0,0,0,0,0,0,0,0,0,0,0
Total (States),9 - Exposure and Abandonment (Section 317 IPC),2014,203,72,275,804,235,1039,54,33,87,5,7,12,48,26,74
Total (UTs),9 - Exposure and Abandonment (Section 317 IPC),2014,1,1,2,30,19,49,0,0,0,0,0,0,0,0,0
Total (All India),9 - Exposure and Abandonment (Section 317 IPC),2014,204,73,277,834,254,1088,54,33,87,5,7,12,48,26,74
A & N Islands,4-Sexual Harrasment/Stalking/other assault,2014,20,0,20,86,0,86,6,0,6,6,0,6,0,0,0
Andhra Pradesh,4-Sexual Harrasment/Stalking/other assault,2014,562,8,570,744,12,756,138,0,138,14,0,14,124,0,124
Arunachal Pradesh,4-Sexual Harrasment/Stalking/other assault,2014,18,0,18,28,0,28,0,0,0,0,0,0,0,0,0
Assam,4-Sexual Harrasment/Stalking/other assault,2014,140,0,140,44,0,44,16,0,16,2,0,2,14,0,14
Bihar,4-Sexual Harrasment/Stalking/other assault,2014,70,0,70,66,0,66,12,0,12,0,0,0,8,0,8
Chandigarh,4-Sexual Harrasment/Stalking/other assault,2014,40,0,40,76,0,76,36,0,36,18,0,18,18,0,18
Chhattisgarh,4-Sexual Harrasment/Stalking/other assault,2014,966,2,968,2348,2,2350,350,0,350,172,0,172,162,0,162
D&N Haveli,4-Sexual Harrasment/Stalking/other assault,2014,0,0,0,0,0,0,0,0,0,0,0,0,0,0,0
Daman & Diu,4-Sexual Harrasment/Stalking/other assault,2014,0,0,0,0,0,0,0,0,0,0,0,0,0,0,0
Delhi UT,4-Sexual Harrasment/Stalking/other assault,2014,1658,4,1662,1982,0,1982,272,0,272,104,0,104,166,0,166
Goa,4-Sexual Harrasment/Stalking/other assault,2014,84,2,86,104,2,106,2,0,2,2,0,2,0,0,0
Gujarat,4-Sexual Harrasment/Stalking/other assault,2014,516,6,522,1058,6,1064,24,0,24,0,0,0,22,0,22
Haryana,4-Sexual Harrasment/Stalking/other assault,2014,640,0,640,676,0,676,230,0,230,34,0,34,196,0,196
Himachal Pradesh,4-Sexual Harrasment/Stalking/other assault,2014,130,0,130,360,2,362,26,0,26,2,0,2,24,0,24
Jammu & Kashmir,4-Sexual Harrasment/Stalking/other assault,2014,16,0,16,28,0,28,12,0,12,0,0,0,12,0,12
Jharkhand,4-Sexual Harrasment/Stalking/other assault,2014,6,0,6,6,0,6,0,0,0,0,0,0,0,0,0
Karnataka,4-Sexual Harrasment/Stalking/other assault,2014,124,4,128,108,0,108,0,0,0,0,0,0,0,0,0
Kerala,4-Sexual Harrasment/Stalking/other assault,2014,400,0,400,672,0,672,44,0,44,10,0,10,34,0,34
Lakshadweep,4-Sexual Harrasment/Stalking/other assault,2014,0,0,0,0,0,0,0,0,0,0,0,0,0,0,0
Madhya Pradesh,4-Sexual Harrasment/Stalking/other assault,2014,5500,10,5510,6194,12,6206,810,2,812,358,0,358,452,2,454
Maharashtra,4-Sexual Harrasment/Stalking/other assault,2014,4672,34,4706,8826,50,8876,1018,8,1026,126,0,126,888,8,896
Manipur,4-Sexual Harrasment/Stalking/other assault,2014,10,0,10,0,0,0,0,0,0,0,0,0,0,0,0
Meghalaya,4-Sexual Harrasment/Stalking/other assault,2014,14,0,14,14,0,14,0,0,0,0,0,0,0,0,0
Mizoram,4-Sexual Harrasment/Stalking/other assault,2014,66,0,66,60,0,60,30,0,30,30,0,30,0,0,0
Nagaland,4-Sexual Harrasment/Stalking/other assault,2014,12,0,12,2,0,2,0,0,0,0,0,0,0,0,0
Odisha,4-Sexual Harrasment/Stalking/other assault,2014,614,64,678,606,64,670,0,0,0,0,0,0,0,0,0
Puducherry,4-Sexual Harrasment/Stalking/other assault,2014,0,0,0,0,0,0,0,0,0,0,0,0,0,0,0
Punjab,4-Sexual Harrasment/Stalking/other assault,2014,354,2,356,268,0,268,62,0,62,32,0,32,30,0,30
Rajasthan,4-Sexual Harrasment/Stalking/other assault,2014,540,10,550,672,10,682,58,0,58,24,0,24,34,0,34
Sikkim,4-Sexual Harrasment/Stalking/other assault,2014,14,0,14,10,0,10,0,0,0,0,0,0,0,0,0
Tamil Nadu,4-Sexual Harrasment/Stalking/other assault,2014,6,0,6,4,0,4,0,0,0,0,0,0,0,0,0
Telangana,4-Sexual Harrasment/Stalking/other assault,2014,630,0,630,536,0,536,38,0,38,6,0,6,32,0,32
Total (All India),4-Sexual Harrasment/Stalking/other assault,2014,27156,146,27302,34322,160,34482,3432,10,3442,1010,0,1010,2392,10,2402
Total (States),4-Sexual Harrasment/Stalking/other assault,2014,25438,142,25580,32178,160,32338,3118,10,3128,882,0,882,2208,10,2218
Total (UTs),4-Sexual Harrasment/Stalking/other assault,2014,1718,4,1722,2144,0,2144,314,0,314,128,0,128,184,0,184
Tripura,4-Sexual Harrasment/Stalking/other assault,2014,156,0,156,410,0,410,64,0,64,0,0,0,62,0,62
Uttar Pradesh,4-Sexual Harrasment/Stalking/other assault,2014,8770,0,8770,7668,0,7668,84,0,84,48,0,48,36,0,36
Uttarakhand,4-Sexual Harrasment/Stalking/other assault,2014,40,0,40,44,0,44,12,0,12,6,0,6,6,0,6
West Bengal,4-Sexual Harrasment/Stalking/other assault,2014,368,0,368,622,0,622,88,0,88,16,0,16,72,0,72
A & N Islands,24-Offences committed against SCs/STs/Others,2014,3,1,4,2,1,3,0,0,0,0,0,0,0,0,0
Andhra Pradesh,24-Offences committed against SCs/STs/Others,2014,225,5,230,195,1,196,85,0,85,2,0,2,83,0,83
Arunachal Pradesh,24-Offences committed against SCs/STs/Others,2014,12,0,12,8,0,8,0,0,0,0,0,0,0,0,0
Assam,24-Offences committed against SCs/STs/Others,2014,556,60,616,230,52,282,10,0,10,10,0,10,0,0,0
Bihar,24-Offences committed against SCs/STs/Others,2014,155,0,155,123,0,123,24,0,24,12,0,12,12,0,12
Chandigarh,24-Offences committed against SCs/STs/Others,2014,15,0,15,22,0,22,8,0,8,6,0,6,2,0,2
Chhattisgarh,24-Offences committed against SCs/STs/Others,2014,708,144,852,822,144,966,145,0,145,45,0,45,100,0,100
D&N Haveli,24-Offences committed against SCs/STs/Others,2014,0,0,0,0,0,0,0,0,0,0,0,0,0,0,0
Daman & Diu,24-Offences committed against SCs/STs/Others,2014,0,0,0,0,0,0,0,0,0,0,0,0,0,0,0
Delhi UT,24-Offences committed against SCs/STs/Others,2014,474,9,483,673,18,691,74,4,78,31,4,35,40,0,40
Goa,24-Offences committed against SCs/STs/Others,2014,6,0,6,5,0,5,0,0,0,0,0,0,0,0,0
Gujarat,24-Offences committed against SCs/STs/Others,2014,336,17,353,395,16,411,5,0,5,3,0,3,2,0,2
Haryana,24-Offences committed against SCs/STs/Others,2014,173,3,176,300,3,303,81,0,81,34,0,34,47,0,47
Himachal Pradesh,24-Offences committed against SCs/STs/Others,2014,57,4,61,76,7,83,3,0,3,2,0,2,1,0,1
Jammu & Kashmir,24-Offences committed against SCs/STs/Others,2014,11,0,11,21,0,21,5,0,5,0,0,0,5,0,5
Jharkhand,24-Offences committed against SCs/STs/Others,2014,76,0,76,61,0,61,14,0,14,8,0,8,6,0,6
Karnataka,24-Offences committed against SCs/STs/Others,2014,1396,33,1429,1458,31,1489,81,0,81,14,0,14,66,0,66
Kerala,24-Offences committed against SCs/STs/Others,2014,1201,26,1227,1951,43,1994,77,3,80,34,2,36,43,1,44
Lakshadweep,24-Offences committed against SCs/STs/Others,2014,6,0,6,6,0,6,0,0,0,0,0,0,0,0,0
Madhya Pradesh,24-Offences committed against SCs/STs/Others,2014,381,8,389,425,8,433,70,0,70,31,0,31,39,0,39
Maharashtra,24-Offences committed against SCs/STs/Others,2014,706,11,717,960,12,972,47,0,47,5,0,5,42,0,42
Manipur,24-Offences committed against SCs/STs/Others,2014,15,0,15,2,0,2,0,0,0,0,0,0,0,0,0
Meghalaya,24-Offences committed against SCs/STs/Others,2014,88,0,88,82,0,82,0,0,0,0,0,0,0,0,0
Mizoram,24-Offences committed against SCs/STs/Others,2014,38,0,38,17,0,17,1,0,1,1,0,1,0,0,0
Nagaland,24-Offences committed against SCs/STs/Others,2014,0,0,0,0,0,0,0,0,0,0,0,0,0,0,0
Odisha,24-Offences committed against SCs/STs/Others,2014,227,2,229,183,2,185,3,0,3,0,0,0,3,0,3
Puducherry,24-Offences committed against SCs/STs/Others,2014,26,4,30,48,4,52,0,0,0,0,0,0,0,0,0
Punjab,24-Offences committed against SCs/STs/Others,2014,120,3,123,154,0,154,16,0,16,7,0,7,9,0,9
Rajasthan,24-Offences committed against SCs/STs/Others,2014,521,2,523,580,2,582,23,0,23,12,0,12,11,0,11
Sikkim,24-Offences committed against SCs/STs/Others,2014,47,0,47,38,0,38,6,0,6,2,0,2,2,0,2
Tamil Nadu,24-Offences committed against SCs/STs/Others,2014,2681,89,2770,1833,61,1894,492,60,552,432,58,490,60,2,62
Telangana,24-Offences committed against SCs/STs/Others,2014,138,5,143,117,5,122,0,0,0,0,0,0,0,0,0
Total (All India),24-Offences committed against SCs/STs/Others,2014,24579,434,25013,25636,418,26054,1791,67,1858,758,64,822,1011,3,1014
Total (States),24-Offences committed against SCs/STs/Others,2014,24055,420,24475,24885,395,25280,1709,63,1772,721,60,781,969,3,972
Total (UTs),24-Offences committed against SCs/STs/Others,2014,524,14,538,751,23,774,82,4,86,37,4,41,42,0,42
Tripura,24-Offences committed against SCs/STs/Others,2014,64,0,64,56,0,56,8,0,8,6,0,6,2,0,2
Uttar Pradesh,24-Offences committed against SCs/STs/Others,2014,12170,0,12170,11788,0,11788,51,0,51,29,0,29,22,0,22
Uttarakhand,24-Offences committed against SCs/STs/Others,2014,172,4,176,170,4,174,27,0,27,8,0,8,19,0,19
West Bengal,24-Offences committed against SCs/STs/Others,2014,1775,4,1779,2835,4,2839,435,0,435,24,0,24,395,0,395
A & N Islands,"17-Immoral Traffic Prevention Act, 1956",2014,2,4,6,0,0,0,0,0,0,0,0,0,0,0,0
Andhra Pradesh,"17-Immoral Traffic Prevention Act, 1956",2014,38,8,46,160,32,192,24,10,34,0,0,0,24,10,34
Arunachal Pradesh,"17-Immoral Traffic Prevention Act, 1956",2014,0,0,0,0,0,0,0,0,0,0,0,0,0,0,0
Assam,"17-Immoral Traffic Prevention Act, 1956",2014,2,0,2,0,0,0,0,0,0,0,0,0,0,0,0
Bihar,"17-Immoral Traffic Prevention Act, 1956",2014,6,0,6,6,0,6,0,0,0,0,0,0,0,0,0
Chandigarh,"17-Immoral Traffic Prevention Act, 1956",2014,0,0,0,0,0,0,0,0,0,0,0,0,0,0,0
Chhattisgarh,"17-Immoral Traffic Prevention Act, 1956",2014,0,0,0,0,0,0,0,0,0,0,0,0,0,0,0
D&N Haveli,"17-Immoral Traffic Prevention Act, 1956",2014,0,0,0,0,0,0,0,0,0,0,0,0,0,0,0
Daman & Diu,"17-Immoral Traffic Prevention Act, 1956",2014,0,0,0,0,0,0,0,0,0,0,0,0,0,0,0
Delhi UT,"17-Immoral Traffic Prevention Act, 1956",2014,0,2,2,22,114,136,0,0,0,0,0,0,0,0,0
Goa,"17-Immoral Traffic Prevention Act, 1956",2014,0,0,0,6,4,10,0,0,0,0,0,0,0,0,0
Gujarat,"17-Immoral Traffic Prevention Act, 1956",2014,4,2,6,4,2,6,0,0,0,0,0,0,0,0,0
Haryana,"17-Immoral Traffic Prevention Act, 1956",2014,4,8,12,4,8,12,0,0,0,0,0,0,0,0,0
Himachal Pradesh,"17-Immoral Traffic Prevention Act, 1956",2014,0,0,0,0,0,0,0,0,0,0,0,0,0,0,0
Jammu & Kashmir,"17-Immoral Traffic Prevention Act, 1956",2014,0,0,0,0,0,0,0,0,0,0,0,0,0,0,0
Jharkhand,"17-Immoral Traffic Prevention Act, 1956",2014,2,0,2,2,0,2,0,0,0,0,0,0,0,0,0
Karnataka,"17-Immoral Traffic Prevention Act, 1956",2014,22,4,26,22,4,26,0,0,0,0,0,0,0,0,0
Kerala,"17-Immoral Traffic Prevention Act, 1956",2014,0,0,0,0,0,0,0,0,0,0,0,0,0,0,0
Lakshadweep,"17-Immoral Traffic Prevention Act, 1956",2014,0,0,0,0,0,0,0,0,0,0,0,0,0,0,0
Madhya Pradesh,"17-Immoral Traffic Prevention Act, 1956",2014,2,6,8,2,6,8,0,0,0,0,0,0,0,0,0
Maharashtra,"17-Immoral Traffic Prevention Act, 1956",2014,46,8,54,1408,80,1488,8,2,10,0,0,0,8,2,10
Manipur,"17-Immoral Traffic Prevention Act, 1956",2014,0,0,0,0,0,0,0,0,0,0,0,0,0,0,0
Meghalaya,"17-Immoral Traffic Prevention Act, 1956",2014,0,0,0,0,0,0,0,0,0,0,0,0,0,0,0
Mizoram,"17-Immoral Traffic Prevention Act, 1956",2014,0,0,0,0,0,0,0,0,0,0,0,0,0,0,0
Nagaland,"17-Immoral Traffic Prevention Act, 1956",2014,0,0,0,0,0,0,0,0,0,0,0,0,0,0,0
Odisha,"17-Immoral Traffic Prevention Act, 1956",2014,2,0,2,2,0,2,0,0,0,0,0,0,0,0,0
Puducherry,"17-Immoral Traffic Prevention Act, 1956",2014,0,0,0,0,0,0,0,0,0,0,0,0,0,0,0
Punjab,"17-Immoral Traffic Prevention Act, 1956",2014,0,0,0,0,0,0,0,0,0,0,0,0,0,0,0
Rajasthan,"17-Immoral Traffic Prevention Act, 1956",2014,0,0,0,0,0,0,0,0,0,0,0,0,0,0,0
Sikkim,"17-Immoral Traffic Prevention Act, 1956",2014,0,0,0,0,0,0,0,0,0,0,0,0,0,0,0
Tamil Nadu,"17-Immoral Traffic Prevention Act, 1956",2014,4,2,6,0,0,0,0,0,0,0,0,0,0,0,0
Telangana,"17-Immoral Traffic Prevention Act, 1956",2014,0,34,34,0,54,54,0,16,16,0,0,0,0,16,16
Total (All India),"17-Immoral Traffic Prevention Act, 1956",2014,276,142,418,1970,368,2338,38,30,68,0,0,0,38,30,68
Total (States),"17-Immoral Traffic Prevention Act, 1956",2014,274,136,410,1948,254,2202,38,30,68,0,0,0,38,30,68
Total (UTs),"17-Immoral Traffic Prevention Act, 1956",2014,2,6,8,22,114,136,0,0,0,0,0,0,0,0,0
Tripura,"17-Immoral Traffic Prevention Act, 1956",2014,0,0,0,0,0,0,0,0,0,0,0,0,0,0,0
Uttar Pradesh,"17-Immoral Traffic Prevention Act, 1956",2014,6,6,12,6,2,8,0,0,0,0,0,0,0,0,0
Uttarakhand,"17-Immoral Traffic Prevention Act, 1956",2014,6,0,6,6,0,6,0,0,0,0,0,0,0,0,0
West Bengal,"17-Immoral Traffic Prevention Act, 1956",2014,130,58,188,320,62,382,6,2,8,0,0,0,6,2,8
A & N Islands,6-Kidnapping / Abduction ,2014,16,0,16,100,0,100,18,0,18,0,0,0,18,0,18
Andhra Pradesh,6-Kidnapping / Abduction ,2014,1350,18,1368,2362,40,2402,552,22,574,10,0,10,542,22,564
Arunachal Pradesh,6-Kidnapping / Abduction ,2014,92,8,100,98,6,104,4,0,4,0,0,0,4,0,4
Assam,6-Kidnapping / Abduction ,2014,304,0,304,88,0,88,10,0,10,2,0,2,8,0,8
Bihar,6-Kidnapping / Abduction ,2014,3376,0,3376,11888,0,11888,890,0,890,44,0,44,846,0,846
Chandigarh,6-Kidnapping / Abduction ,2014,96,0,96,260,0,260,106,0,106,14,0,14,92,0,92
Chhattisgarh,6-Kidnapping / Abduction ,2014,1818,48,1866,4536,48,4584,744,4,748,200,0,200,540,4,544
D&N Haveli,6-Kidnapping / Abduction ,2014,6,0,6,72,0,72,0,0,0,0,0,0,0,0,0
Daman & Diu,6-Kidnapping / Abduction ,2014,4,0,4,10,0,10,0,0,0,0,0,0,0,0,0
Delhi UT,6-Kidnapping / Abduction ,2014,968,16,984,5768,12,5780,508,0,508,156,0,156,328,0,328
Goa,6-Kidnapping / Abduction ,2014,68,12,80,200,16,216,4,0,4,0,0,0,4,0,4
Gujarat,6-Kidnapping / Abduction ,2014,3536,102,3638,15362,278,15640,810,12,822,42,4,46,700,8,708
Haryana,6-Kidnapping / Abduction ,2014,748,14,762,2354,22,2376,814,14,828,94,4,98,720,10,730
Himachal Pradesh,6-Kidnapping / Abduction ,2014,176,8,184,608,24,632,76,0,76,2,0,2,72,0,72
Jammu & Kashmir,6-Kidnapping / Abduction ,2014,240,4,244,882,4,886,76,0,76,0,0,0,76,0,76
Jharkhand,6-Kidnapping / Abduction ,2014,184,0,184,200,0,200,28,0,28,20,0,20,8,0,8
Karnataka,6-Kidnapping / Abduction ,2014,1406,36,1442,2388,48,2436,250,2,252,12,0,12,238,2,240
Kerala,6-Kidnapping / Abduction ,2014,314,6,320,1558,6,1564,72,0,72,0,0,0,72,0,72
Lakshadweep,6-Kidnapping / Abduction ,2014,0,0,0,0,0,0,0,0,0,0,0,0,0,0,0
Madhya Pradesh,6-Kidnapping / Abduction ,2014,5308,94,5402,9034,96,9130,1590,22,1612,510,10,520,1080,12,1092
Maharashtra,6-Kidnapping / Abduction ,2014,3056,228,3284,15228,484,15712,582,30,612,34,0,34,536,30,566
Manipur,6-Kidnapping / Abduction ,2014,30,0,30,0,0,0,0,0,0,0,0,0,0,0,0
Meghalaya,6-Kidnapping / Abduction ,2014,44,0,44,134,0,134,0,0,0,0,0,0,0,0,0
Mizoram,6-Kidnapping / Abduction ,2014,2,2,4,4,2,6,0,0,0,0,0,0,0,0,0
Nagaland,6-Kidnapping / Abduction ,2014,14,0,14,10,0,10,6,0,6,6,0,6,0,0,0
Odisha,6-Kidnapping / Abduction ,2014,778,6,784,1728,22,1750,96,2,98,6,0,6,90,2,92
Puducherry,6-Kidnapping / Abduction ,2014,10,0,10,14,0,14,0,0,0,0,0,0,0,0,0
Punjab,6-Kidnapping / Abduction ,2014,1262,54,1316,2038,48,2086,360,20,380,94,0,94,266,20,286
Rajasthan,6-Kidnapping / Abduction ,2014,1690,42,1732,5310,92,5402,738,18,756,262,4,266,468,14,482
Sikkim,6-Kidnapping / Abduction ,2014,12,0,12,8,0,8,0,0,0,0,0,0,0,0,0
Tamil Nadu,6-Kidnapping / Abduction ,2014,846,28,874,2370,10,2380,560,6,566,124,2,126,436,4,440
Telangana,6-Kidnapping / Abduction ,2014,1496,6,1502,2470,14,2484,466,8,474,20,0,20,446,8,454
Total (All India),6-Kidnapping / Abduction ,2014,56258,2046,58304,138158,3050,141208,15866,540,16406,4526,188,4714,11112,352,11464
Total (States),6-Kidnapping / Abduction ,2014,55158,2030,57188,131934,3038,134972,15234,540,15774,4356,188,4544,10674,352,11026
Total (UTs),6-Kidnapping / Abduction ,2014,1100,16,1116,6224,12,6236,632,0,632,170,0,170,438,0,438
Tripura,6-Kidnapping / Abduction ,2014,146,2,148,294,4,298,26,0,26,6,0,6,20,0,20
Uttar Pradesh,6-Kidnapping / Abduction ,2014,21932,1142,23074,44538,1632,46170,5912,372,6284,2832,164,2996,2970,208,3178
Uttarakhand,6-Kidnapping / Abduction ,2014,236,0,236,476,0,476,56,0,56,32,0,32,24,0,24
West Bengal,6-Kidnapping / Abduction ,2014,4694,170,4864,5768,142,5910,512,8,520,4,0,4,508,8,516
